AG	SbSgFmAbbr	Aktiengesellschaft	SbSgFm
Aachen	NmGeogCity.De
Aal	SbSgMsZool
Aall	xx
Aar	xx
Aare	NmFmGeogFlum
Aas	SbSgNt
Aast	xx
Abbe	NmSurn
Abc	xx
Abel	NmMsPren
Abt	SbSgMsProf
Ac	xx
Ach	SbSgNt
Ache	SbSgFm
Achse	SbSgFm
Achsel	SbSgFm
Achter	SbSgMs
Acker	SbSgMs
Acre	SbSgMsForg.En
Act	SbSgMsForg.En
Ade	Rp
Adel	SbSgMs	adeln	VbIn
Aden	NmGeogCityForg.Ye
Ader	SbSgFmBody
Adler	SbSgMsZool
Affchen:	SbSgNtDimtZool	Affe	SbSgMsZool
Affe	SbSgMsZool
After	SbSgMsBody
Ah	AbMeas
Ahle	SbSgFm
Ahn	SbSgMs
Ahne	SbSgMs
Ahr	xx
Ahre:	SbSgFm
Ai	SbSgNtZool
Aide	xx
Aids	AbMedc
Air	SbSgFmForg.En
Aitel	xx
Akme	xx
Akne	SbSgFmMedc
Akt	SbSgMs
Akte	SbSgFm
Al	xx
Alb	SbSgMs
Albe	SbSgFm
Alchen:	xx
Ale	SbSgNtNutr
Alf	xx
Alge	SbSgFmBota
Alk	xx
Alke	xx
Alkje	xx
Aller	xx
Alm	SbSgFm
Almer	xx
Alp	SbSgMs
Alpe	xx
Alpler:	SgSbMsPers
Alster	NmGeogFlum
Alte	SbSgFm
Alter	SbSgNt
Ambe	xx
Amber	xx
Amme	SbSgFmProf
Ammer	NmGeogFlum
Ampel	SbSgFm
Amper	NmGeogFlum
Ampfer	xx
Amsel	SbSgFmZool
Amt	SbSgNt
Amtchen:	xx
Anden	NmGeogMontForg.Ar
Angel	SbSgFm	angeln	VbIn
Anger	SbSgMs
Angler	SbSgMs
Angst	SbSgFm
Anke	NmFmPren
Anken	xx
Anker	SbSgMs
Annchen:	xx
Anne	NmFmPren
Anne:	xx
Anse	xx
Ante	xx
Antje	NmFmPren
Apfel	SbSgMs
Aphel	xx
Aphthe	xx
Ar	SbSgNtMeas
Arche	SbSgFmBibl
Are	xx
Aren:	xx
Arge	SgSbFmAbbr	Arbeitsgemeinschaft	SbSgFm
Arger:	SbSgMs	arg	Aj
Arm	SbSgMsBody
Armchen:	SbSgNtDimtBody	Arm	SbSgMsBody
Arme	SgPlBody	Arm	SgSbMsBody
Armel:	SbSgMs
Arndt	NmSurn
Arsch	SbSgMsVulg
Arsen	SbSgNtChem
Art	SbSgFm
Artel	xx
Arve	xx
Arzt	SbSgMsProf
Asch	xx
Asche	SbSgFm
Asche:	xx
Ascher	SbSgMs
Ascher:	xx
Ase	xx
Aser	xx
Aser:	SbSgMsZool
Assel	SbSgFmZool
Ast	SbSgMs
Astchen:	SbSgNtDimt	Ast	SbSgMs
Aster	SbSgFmBota
Ate	xx
Athen	NmGeogCityForg.Gr
Ather:	SbSgMsChem
Atze	xx
Atzel	xx
Au	SbSgFm
Aue	SbSgFm
Auge	SbSgNtBody
Aule	xx
Auster	SbSgFmZool
Ave	xx
Axel	NmMsPren
Axt	SbSgFm
Ba	xx
Baal	NmBibl
Baar	NmSurn
Baas	xx
Babel	NmBibl
Bach	SbSgMs
Bache	xx
Backchen:	SbSgNtDimtBody	Backe	SbSgFmBody
Backe	SbSgFmBody
Backer:	SbSgMsProf
Bad	SbSgNt
Bader	NmSurn	baden	VbIn
Bafel	xx
Bagger	SbSgMs
Bahn	SbSgFm
Bahre	SbSgFm
Baht	xx
Bai	xx
Baier	NmSurn
Baiser	SbSgNtNutrForg.Fr
Baisse	SbSgFmForg.Fr
Bake	SbSgFm
Bakken	xx
Balde:	xx
Baldr	xx
Balg	SbSgMs
Balge	SbSgFm
Balkchen:	SbSgNtDimt	Balken	SbSgMs
Balken	SbSgMs
Ball	SbSgMs
Ballchen:	SbSgNtDimt	Ball	SbSgMs
Balte	SbSgMsGeogRegn
Balz	SbSgFm
Bammel	SbSgMs	bammeln	VbIn
Ban	xx
Band	SbSgNt
Bandchen:	SbSgNtDimt	Band	SbSgNt
Bande	SbSgFm
Bandel:	xx
Bandl	SbSgNtDimtDial
Bandsel:	xx
Bank	SbSgFm
Bankchen:	SbSgNtDimt	Bank	SbSgFm
Banker	SbSgMsProf	Bank	SbSgFm
Bankler:	SbSgMsPers
Bann	SbSgMs
Banner	SbSgNt	bannen	VbIn
Banse	xx
Bar:	SbSgMsZool
Barbe	SbSgFmZool
Barbel:	NmFmPren
Barde	SbSgMs
Bark	xx
Barke	SbSgFm
Barme:	xx
Barmer	SbSgMsPersGeogCity.De	Barmen	NmGeogCity.De
Barn	xx
Barre	xx
Barrel	SbSgNtMeasForg.Us
Bart	SbSgMsBody
Bartchen:	SbSgNtDimtBody	Bart	SbSgMsBody
Barte	xx
Bartel	NmSurn
Barthel	NmSurn
Baschen:	SbSgNtDimtPers	Base	SbSgFmPers
Base	SbSgFmPers
Basel	NmGeogCityForg.Ch
Basen	SbPlFm	Base	SbSgFm
Baske	SbSgMsPersGeogRegn
Basler	SbSgMsPersGeogCityForg.Ch	Basel	NmGeogCityForg.Ch
Basse	xx
Bast	SbSgMs
Baste	xx
Bastler	SbSgMs
Batzen	SbSgMs
Bau	SbSgMs
Bauch	SbSgMsBody
Baud	SbSgNtMeas
Baude	xx
Bauer	SbSgMs	bauen	VbIn
Baum	SbSgMsBota
Baumchen:	SbSgNtDimtBota	Baum	SbSgMsBota
Bausch	SbSgMs
Bauschel:	xx
Baute	xx
Bauten	SbPlFm	Bau	SbSgMs
Bautzen	NmGeogCity.De
Bebel	NmSurn
Becher	SbSgMs
Becken	SbSgNt
Bede	xx
Beeper	SbSgMsForg.En
Beere	SbSgFm
Beet	SbSgNt
Beete	SbSgFm
Befehl	SbSgMs
Beffchen	SbSgNtDimt
Beg	xx
Beginn	SbSgMs
Beichte	SbSgFm
Beil	SbSgNt
Bein	SbSgNtBody
Beisel	SbSgNt
Beitel	SbSgMs
Beiz	xx
Beize	SbSgFm
Beizer	SbSgMs	beizen	VbIn
Beißel	xx
Beißer	SbSgMs	beißen	VbIn
Belchen	NmGeogMont
Beller	NmSurn
Belt	NmGeogRegn
Bembel	SbSgMs
Bemmchen	SbSgNtDimt	Bemme	SbSgFm
Bemme	SbSgFm
Bendel	SbSgMs
Bengel	SbSgMs
Benn	NmSurn
Benne	xx
Benz	NmSurn
Berber	SbSgMsPersGeogRegn
Berg	SbSgMs
Berge	SbPl	Berg	SbSgMs
Bergler	SbSgMsPers
Berme	xx
Bern	NmGeogCityForg.Ch
Bernd	NmMsPren
Berner	SbSgMsPersGeogCityForg.Ch	Bern	NmGeogCityForg.Ch
Bernt	xx
Bert	NmMsPren
Beschwer	xx
Besen	SbSgMs
Best	xx
Bete	SbSgFmNutr
Betel	NmSurn
Beter	SbSgMs	beten	VbIn
Bethel	NmGeogCity.De
Bett	SbSgNt
Bettel	SbSgMs	betteln	VbIn
Bettler	SbSgMs
Beuche	xx
Beuge	SbSgFm
Beugel	NmSurn
Beuger	SbSgMs	beugen	VbIn
Beule	SbSgFm
Beuschel	SbSgNt
Beute	SbSgFm
Beutel	SbSgMs	beuteln	VbIn
Beutler	NmSurn
Beutner	NmSurn
Bibel	SbSgFm
Biber	SbSgMsZool
Biege	SbSgFm
Biel	NmGeogCityForg.Ch
Bien	xx
Bienchen	SbSgNtDimt	Biene	SbSgFm
Biene	SbSgFm
Bier	SbSgNtNutr
Biese	xx
Biest	SbSgNt
Bieter	SbSgMs	bieten	VbIn
Bike	SbSgNtForg.En
Biker	SbSgMsPersForg.En	Bike	SbSgNtForg.En
Bilch	SbSgMsZool
Bild	SbSgNt
Bildchen	SbSgNtDimt	Bild	SbSgNt
Bildner	xx
Bilge	SbSgFm
Bill	NmMsPrenForg.Us
Bim	xx
Bimmel	SbSgFm	bimmeln	VbIn
Binde	SbSgFm
Binder	SbSgMs	binden	VbIn
Binge	xx
Bingen	NmGeogCity.De
Binger	xx
Binkel	xx
Binse	SbSgFmBota
Birger	xx
Birke	SbSgFmBota
Birne	SbSgFmNutr
Birr	NmGeogCityForg.Ir
Birte	xx
Bise	xx
Biss	SbSgMs
Bissen	SbPlAc	Biss	SbSgMs
Bisten	xx
Bister	xx
Bit	SbSgNtMeas
Bitte	SbSgFm	bitten	VbInStrg
Bittre	xx
Bitzler	xx
Bjorn:	NmMsPren
Blache	xx
Blade	xx
Blaffer	SbSgMs	blaffen	VbIn
Blaffer:	xx
Blag	SbSgNtVulg
Blage	xx
Blagen	SbPlVulg		Blag	SbSgNtVulg
Blahe	xx
Blaker	xx
Blanke:	xx
Blaschen:	SbSgNtDimt	Blase	SbSgFm
Blase	SbSgFm
Blaser:	SbSgMsPers
Blasse:	SbSgFm
Blatt	SbSgNtBota
Blattchen:	SbSgNtDimtBota	Blatt	SbSgNtBota
Blatter	SbSgFm
Blaue	xx
Blaue:	SbSgFm
Blazer	SbSgMsForg
Blech	SbSgNt
Blechner	SbSgMsProf	Blech	SbSgNt
Blei	SbSgNtMetl
Bleibe	SbSgFm	bleiben	VbInStrg
Bleiche	SbSgFm	bleichen	VbInStrg
Blend	xx
Blende	SbSgFm
Blender	SbSgMs	blenden	VbIn
Blesse	xx
Bleuel	xx
Blick	SbSgMs
Blinde	SbSgMsPers
Blinker	SbSgMs	blinken	VbIn
Blister	xx
Blitz	SbSgMs
Bloch	NmSurn
Blocher	SbSgMs	blochen	VbIn
Block	SbSgMs
Blocker	SbSgMs	blocken	VbIn
Blodel:	SbSgMsVulg
Blondchen	SbSgNtDimtPers	Blonde	SbSgFmPers
Blonde	SbSgFmPers
Bloße:	SbSgFm
Blucher:	NmSurn
Blues	SbSgMsForg.Us
Bluff	SbSgMsForg
Blumchen:	SbSgNtDimt	Blume	SbSgFm
Blume	SbSgFm
Blunze	xx
Blunzen	xx
Bluse	SbSgFm
Bluse:	xx
Blust	xx
Blut	SbSgNtBody
Blute:	SbSgFm
Bluter	SbSgMs	bluten	VbIn
Bo:	SbSgFmMeto
Bob	NmMsPrenForg.En
Bober	xx
Boche	xx
Bock	SbSgMs
Bockchen:	SbSgNtDimtZool	Bock	SbSgMs
Bockser:	xx
Bodden	xx
Boden	SbSgMs
Boe:	xx
Bogen	SbSgMs	biegen	VbInStrg
Bohle	SbSgFm
Bohme:	SbSgMsPersGeogRegn
Bohmen:	NmGeogRegn
Bohnchen:	SbSgNtDimt	Bohne	SbSgFm
Bohne	SbSgFm
Bohner	xx
Bohrer	SbSgMs	bohren	VbIn
Boje	SbSgFm
Bol	xx
Boll:	NmSurn
Bolle	NmSurn
Boller:	SbSgMs
Bombe	SbSgFm
Bomber	SbSgMs	bomben	VbIn
Bommel	SbSgMs
Bon	SbSgMsForg
Bond	xx
Bonn	NmGeogCity.De
Bonner	SbSgMsGeogCity.De	Bonn	NmGeogCity.De
Bontje	xx
Bonze	SbSgMsPers
Boot	SbSgNt
Bor	SbSgNtChem
Bord	SbSgNt
Borde:	SbSgFm
Borg	xx
Borke	SbSgFmBota
Born	SbSgMs
Borne:	xx
Borschtsch	SbSgMsNutrForg.Ru
Borse:	SbSgFm
Borste	SbSgFm
Borte	xx
Bosch	NmSurn
Boss	SbSgMsPers
Botchen:	SbSgNtDimt	Boot	SbSgNt
Bote	SbSgMsPers
Botel	xx
Bott	xx
Bottcher:	SbSgMsProf
Botten	xx
Bowle	SbSgFmForg
Box	SbSgFmForg.En
Boxer	SbSgMs	boxen	VbIn
Bozen	NmGeogCityForg.It
Bozner	SbSgMsPersGeogCityForg.It	Bozen	NmGeogCityForg.It
Boßel	xx
Brache	xx
Brachse	xx
Brachsen	xx
Brachsmen	xx
Brack	xx
Bracke	xx
Bragen:	xx
Brahms	NmSurn
Bram	SbSgMs
Bramme	xx
Branche	SbSgFm
Brand	SbSgMs	brennen	VbInStrg
Brass	xx
Brasse	xx
Brat	xx
Brat:	SbSgNt
Brater:	SbSgMs
Bratsche	SbSgFmMusi
Bratscher	xx
Brau:	xx
Brauch	SbSgMs
Braue	SbSgFmBody
Brauer	SbSgMs	brauen	VbIn
Braune	xx
Braune:	SbSgFm
Braus	SbSgMs
Brausche	xx
Brause	SbSgFm
Braut	SbSgFmPers
Brecher	SbSgMs	brechen	VbIn
Brecht	NmSurn
Bregen	xx
Brehm	NmSurn
Brei	SbSgMs
Brein	xx
Breite	SbSgFm	breit	Aj
Breme	xx
Bremen	NmGeogCity.De
Bremer	SbSgMsPersGeogCity.De	Bremen	NmGeogCity.De
Bremse	SbSgFm
Bremser	SbSgMs	bremsen	VbIn
Brenner	SbSgMs	brennen	VbIn
Brent	xx
Brente	xx
Bresche	SbSgFm
Brett	SbSgNt
Brettel	SbSgNtDimt	Brett	SbSgNt
Brettl	SbSgNtDimtDial
Bretzel	SbSgFm
Breughel	NmSurn
Breve	SbSgFmMusi
Breze	SbSgFmDial
Brezel	SbSgFm
Brezen	SbPlDial	Breze	SbSgFmDial
Bricke	xx
Bride	xx
Bridge	SbSgNtForg.En
Brie	SbSgMsNutr
Brief	SbSgMs
Brienz	xx
Bries	SbSgNt
Brieschen	SbSgNtDimt	Bries	SbSgNt
Brigg	xx
Briggs	xx
Brille	SbSgFm
Brimsen	xx
Bringer	SbSgMs	bringen	VbIn
Brise	SbSgFmMeto
Brit	NmFmPren
Britannien	NmGeogCtry.En
Brite	SbSgMsPersGeogCtry.En	Britannien	NmGeogCtry.En
Britten	xx
Brno	xx
Broch	xx
Brockchen:	xx
Brod	xx
Brodler	xx
Broker	SbSgMsProfForg.En
Brom	SbSgNtChem
Bronze	SbSgFmMetl
Brosche	SbSgFm
Broschen:	xx
Brosel:	SbSgMsDimt
Brot	SbSgNtNutr
Brotchen:	SbSgNtDimtNutr	Brot	SbSgNtNutr
Browser	SbSgMsForg.En
Bruch	SbSgMs	brechen	VbInStrg
Bruckchen:	SbSgNtDimt	Brucke:	SbSgFm
Brucke:	SbSgFm
Bruckner	NmSurn
Bruden:	xx
Bruder	SbSgMsPers
Bruegel	NmSurn
Brueghel	NmSurn
Brugge:	NmGeogCityForg.Be
Bruhe:	SbSgFmNutr
Bruller:	SbSgMs
Brummer	SbSgMs	brummen	VbIn
Brunch	SbSgMsNutrForg.En
Brunft	SbSgFm
Brunn:	NmGeogCityForg.At
Brunnchen:	SbSgNtDimt	Brunnen	SbSgMs
Brunne:	xx
Brunnen	SbSgMs
Brunst	SbSgFm
Brussel	xx
Brussel:	NmGeogCityForg.Be
Brussler:	SbSgMsGeogCityForg.Be	Brussel:	NmGeogCityForg.Be
Brust	SbSgFmBody
Brustchen:	SbSgNtDimtBody	Brust	SbSgFmBody
Bruter:	SbSgMs
Bub	SbSgMsPers
Bubchen:	SbSgNtDimtPers	Bub	SbSgMsPers
Bube	SbSgMs
Buch	SbSgNt
Buche	SbSgFmBota
Buchel	xx
Buchner:	NmSurn
Buchs	SbSgMs
Buchse	SbPl
Buchse:	SbSgFm
Bucht	SbSgFm
Buchtel	xx
Bucke:	SbSgFm
Buckel	SbSgMs	buckeln	VbIn
Budchen:	SbSgNtDimt	Bude	SbSgFm
Buddel	SbSgFm	buddeln	VbIn
Bude	SbSgFm
Budel	xx
Budner:	xx
Buffel:	SbSgMsZool
Bug	SbSgMs
Bugel:	SbSgMs
Buh	Rp
Buhel:	xx
Buhl:	NmGeogCity.De
Buhle	SbSgMs
Buhler	SbSgMs	buhlen	VbIn
Buhne	SbSgFm
Buhne:	SbSgFmDiar
Bulle	SbSgMsZool
Bult	xx
Bulte:	xx
Bummel	SbSgMs	bummeln	VbIn
Bummler	SbSgMs
Bums	SbSgMsVulg
Bund	SbSgMs	binden	VbStrgIn
Bundchen:	SbSgNtDimt	Bund	SbSgMs
Bundel:	SbSgNt
Bunden:	SbPlAc	Bund	SbSg
Bundner:	SbSgMsPersGeogRegnForg.Ch
Bunge	xx
Bunker	SbSgMs
Burde:	SbSgFm
Bure	SbSgMsPers
Burg	SbSgFm
Burge:	SbSgMsPers
Burger	NmSurn
Burger:	SbSgMsPers
Burns	xx
Bursch	SbSgMsPers
Burschchen:	SbSgNtDimtPers	Bursch	SbSgMsPers
Bursche	SbSgMsPers
Burse	xx
Burstchen:	SbSgNtDimt	Burste:	SbSgFm
Burste:	SbSgFm
Burzel:	SbSgMs
Bus	SbSgMs
Busch	SbSgMsBota
Buschchen:	SbSgNtDimtBota	Busch	SbSgMsBota
Buschel:	SbSgNt
Buschen	SbPl	Busch	SbSgMs
Buschen:	SbPlAc	Busch	SbSgMs
Busen	SbSgMsBody
Bushel	SbSgNtForg
Buste:	SbSgFm
Butler	SbSgMsForg
Butscher	xx
Butt	SbSgMsZool
Butt:	SbSgFm
Butte	xx
Butte:	SbSgFm
Buttel	xx
Buttel:	SbSgMsPers
Butten:	SbPlFm	Butte:	SbSgFm
Butter	SbSgFmNutr
Buttje	xx
Buttjer	xx
Buttner:	xx
Butz	SbSgMs
Butzchen:	SbSgNtDimt	Butz	SbSgMs
Butze	xx
Butzen	SbPl	Butz	SbSgMs
Bux:	xx
Buxe	xx
Buzzer	xx
Buße	SbSgFm
Bußer:	SbSgMsPers
Ca	xx
Cab	xx
Cache	xx
Calbe	xx
Calw	NmGeogCity.De
Calwer	SbSgMsGeogCity.De	Calw	NmGeogCity.De
Camp	SbSgNtForg.En
Camper	SbSgMsForg	campen	VbInForg
Cape	SbSgNtForg.En
Car	SbSgMsForg.En
Carl	NmMsPren
Carmen	NmFmPren
Carsten	NmMsPren
Carver	xx
Catcher	SbSgMsPersForg.En
Celle	NmGeogCity.De
Celler	SbSgMsPersGeogCity.De	Celle	NmGeogCity.De
Cent	SbSgMsCurr
Center	SbSgMsForg.En	Cent	SbSgMsCurr
Cercle	xx
Chaine	xx
Chaise	SbSgFmVulg
Cham	NmGeogCity.De
Champ	xx
Chan	xx
Chance	SbSgFm
Change	SbSgMsForg.Fr
Charge	SbSgFm
Charme	SbSgMsForg.Fr
Chart	SbSgFmForg.En
Charte	xx
Charter	SbSgNt
Charts	SbPlForg.En	Chart	SbSgFmForg.En
Chat	SbSgMsForg.En
Chatte	xx
Chatter	SbSgMsPers
Chaucer	xx
Chauke	xx
Cheb	xx
Check	SbSgMsForg.En
Chef	SbSgMsPersForg
Cheib	xx
Chester	NmGeogCityForg.En
Chi	SbSgNtLetr.Gr
Chiffre	SbSgFmForg.Fr
Chile	NmGeogCtry
Chintz	SbSgMsClthForg
Chip	SbSgMsForg.En
Chloe	NmFmPrenForg
Chlor	SbSgMsChem
Choke	SbSgMs
Choker	xx
Chopper	xx
Chor	SbSgMsMusi
Chorchen:	SbSgNtDimtMusi	Chor	SbSgMsMusi
Chose	SbSgFmForg.Fr
Christ	SbSgMsPers
Christel	NmFmPren
Christl	NmFmPrenDimt
Chrom	SbSgNtMetl
Chur	NmGeogCityForg.Ch
Chuzpe	SbSgMsForg.Il
Ci	xx
Cid	NmTitl
Cidre	SbSgMsNutrForg.Fr
Circe	NmFmPrenForg
Claim	SbSgMsForg.Us
Clan	SbSgMsForg.En
Claudel	NmMsPren
Claus	NmMsPren
Clerk	SbSgMsForg.En
Clinch	SbSgMsForg.En
Clip	SbSgMsForg.En
Clog	xx
Cloth	xx
Clown	SbSgMsProfForg.En
Club	SbSgMsForg.En
Cluster	SbSgNtForg.En
Co	Ab	Companie	SbSgFm
Cobbler	xx
Code	SbSgMsForg.En
Cop	SbSgProfAbbrForg.En	Corporal	SbSgMsProfForg.En
Cord	SbSgMsClthForg.En
Core	SbSgMsForg.En
Corner	SbSgMsForg.En
Corps	SbSgNtForg.Fr
Cover	SbSgNtForg.En
Cowper	xx
Crack	SbSgMsForg
Cracker	SbSgMsNutrForg	Crack	SbSgMsForg
Crash	SbSgMsForg.En
Crawl	SbSgMsForg.En
Creek	xx
Crew	SbSgFmForg.En
Crux	SbSgFmForg.Lt
Cu	xx
Cup	SbSgMsForg.En
Cut	SbSgMsForg.En
Cutter	SbSgMsForg	cutten	VbInForg
Dach	SbSgNt
Dachs	SbSgMsZool
Dachschen:	SbSgNtDimtZool	Dachs	SbSgMsZool
Dachsel:	xx
Dachtel	xx
Dackel	SbSgMsZool
Dad	SbSgMsPersForg.En
Daffke	xx
Dahle:	xx
Daimler	NmSurn
Daker	xx
Dalbe	xx
Dalben	xx
Dalk	xx
Dalle	xx
Damchen:	SbSgNtDimtPers	Dame	SbSgFmPers
Dame	SbSgFmPers
Damel:	xx
Damm	SbSgMs
Dammer:	SbSgMs
Dampf	SbSgMs
Dampfer	SbSgMs
Dampfer:	SbSgMsDiar
Dampfl	xx
Dan	NmGeogFlumForg.Il
Dane:	SbSgMsPersGeogCtry.Dk	Danemark:	NmGeogCtry.Dk
Danemark:	NmGeogCtry.Dk
Daphne	NmFmPrenForg.Gr
Darg	xx
Dark	xx
Darm	SbSgMsBody
Darre	xx
Darts	xx
Darß	NmGeogRegn.De
Date	SbSgFm
Daten	SbPl	Date	SbSgFm
Datscha	SbSgFm
Dattel	SbSgFmNutr
Dau	xx
Daube	SbSgFm
Daubel	xx
Dauer	SbSgFm
Daumchen:	SbSgNtDimtBody	Daumen	SbSgMsBody
Daumen	SbSgMsBody
Daunen	SbPl	Daune	SbSgFm
Daus	xx
Dazzler	xx
Decher	xx
Dechsel	xx
Deck	SbSgNt
Decke	SbSgFm
Deckel	SbSgMs	deckeln	VbIn
Deern	SbSgFmPersDial
Degen	SbSgMs
Deibel	SbSgMsVulg	Teufel	SbSgMs
Deich	SbSgMs
Deichsel	SbSgFm
Deist	xx
Deiwel	SbSgMsVulg	Teufel	SbSgMs
Deixel	xx
Delft	NmGeogCityForg.Nl
Delfter	SbSgMsGeogCityForg.Nl	Delft	NmGeogCityForg.Nl
Delle	SbSgFm
Demen	xx
Dengel	SbSgFm	dengeln	VbIn
Denke	SgSgFm	denken	VbIn
Denker	SbSgMs	denken	VbIn
Denver	NmGeogCityForg.Us
Depp	SbSgMsPersVulg
Derk	xx
Deubel	SbSgMsVulg	Teufel	SbSgMs
Deut	SbSgMs
Deuter	SbSgMs	deuten	VbIn
Deutler	SbSgMsPers
Deutsche	SbPlPers
Dez	SbSgMsVulg
Dhau	xx
Dichte	SbSgFm
Dichter	SbSgMs	dichten	VbIn
Dickte	xx
Dieb	SbSgMsPers
Diele	SbSgFm
Dieme	xx
Diemen	xx
Diener	SbSgMs	dienen	VbIn
Dienst	SbSgMs
Dierk	xx
Diesel	SbSgMs	dieseln	VbIn
Dieter	NmMsPren
Diether	xx
Dike	xx
Dill	SbSgMsNutr
Dime	SbSgNtCurrForg.Us
Dimmer	SbSgMs
Diner	SbSgNtForg.Fr
Ding	SbSgNt
Dings	SbGe	Ding	SbSgNt
Dink	xx
Dinkel	SbSgMsNutr
Dinner	SbSgNtForg.En
Dip	SbSgMsForg.En
Dippel	xx
Dirk	NmMsPren
Dirn	SbSgFmPers
Dirndl	SbSgNt
Dirne	SbSgFmPers
Disc	SbSgFm
Disk	SbSgFm
Disken	xx
Disse	xx
Distel	SbSgFmBota
Disthen	xx
Dittchen	xx
Ditte	xx
Dix	NmSurn
Djembe	xx
Dnjepr	NmGeogFlumForg.Ru
Dnjestr	NmGeogFlumForg.Ru
Dobel	SbSgMs
Dobel:	xx
Docht	SbSgMs
Dock	SbSgNt
Docke	xx
Docker	SbSgMs	docken	VbIn
Dodel:	SbSgMsPersVulg
Doge	SbSgMsPers
Dogge	SbSgFmZool
Dogger	xx
Dohle	SbSgFmZool
Dohne	xx
Dolch	SbSgMsMilt
Dolde	xx
Dole	xx
Dolf	xx
Dolle	xx
Dollen	xx
Dolmen	SbSgMs
Dom	SbSgMs
Don	SbSgTitlForg.It
Don	SbSgMsGeogFlumForg.Ru
Doner:	SbSgMsNutrForg.Tr
Dong	xx
Donner	SbSgMs
Dope	xx
Doppel	SbSgNt	doppeln	VbIn
Doppler	NmSurn
Dorchen	NmFmPrenDimt
Dorer	xx
Dorf	SbSgNt
Dorfchen:	SbSgNtDimt	Dorf	SbSgNt
Dorfler:	SbSgMsPers
Dorn	SbSgMs
Dornchen:	SbSgNtDimt	Dorn	SbSgMs
Dorre:	xx
Dorsch	SbSgMsZool
Dos	xx
Doschen:	SbSgNtDimt	Dose	SbSgFm
Dose	SbSgFm
Dosen	SbPl	Dose	SbSgFm
Dost	xx
Dotter	SbSgMs
Dover	NmGeogCityForg.En
Drache	SbSgMsZool
Drachen	SbPl	Drache	SbSgMs
Drachme	SbSgFmCurrForg.Gr
Draggen	xx
Drahrer	xx
Draht	SbSgMs
Drahtchen:	SbSgNtDimt	Draht	SbSgMs
Drain	xx
Drake	NmSurnForg.En
Dran:	xx
Drang	SbSgMs	drangen:	VbInStrg
Drangler:	SbSgMsPers
Drank	xx
Drasch	xx
Drau	xx
Drechsler	SbSgMs
Dreck	SbSgMs
Dredsche	xx
Dreesch	xx
Dreh	SbSgMs
Drehe	xx
Dreher	SbSgMs	drehen	VbIn
Dreier	SbSgMs
Drell	xx
Drempel	xx
Dresche	SbSgFm	dreschen	VbInStrg
Drescher	SbSgMs	dreschen	VbIn
Dresden	NmGeogCity.De
Dresdner	SbSgMsPersGeogCity.De
Dress	xx
Driesch	xx
Drift	SbSgFm
Drilch	xx
Drill	SbSgMsForg.En
Drink	SbSgMsForg.En
Drischel	xx
Drive	SbSgMsForg.En
Driver	SbSgMsForg.En	Drive	SbSgMsForg.En
Droge	SbSgFm
Drohn	xx
Drohne	SbSgFmZool
Dronte	xx
Drops	SbSgMsForg
Droschke	xx
Drossel	SbSgFm	drosseln	VbIn
Drost	xx
Druck	SbSgMs
Drucker	SbSgMs
Drucker:	SbSgMsDiar
Drud	xx
Drude	xx
Drummer	SbSgMsPersForg.En
Drums	xx
Drusch	xx
Druse	SbSgFm
Druse:	SbSgFmDiar
Drusen	SbPl	Druse	SbSgFm
Dschebel	xx
Dschinn	xx
Dschungel	SbSgMs
Dschunke	SbSgFm
Dubel:	xx
Duc	xx
Ducht	xx
Ducker	SbSgMs	ducken	VbIn
Dudler	xx
Duell	SbSgNtForg
Duett	SbSgMsForg
Duffel:	xx
Duft	SbSgMs
Duftchen:	SbSgNtDimt	Duft	SbSgMs
Duke	SbSgMsPersForg.En
Duker:	SbSgMs
Dulder	SbSgMs	dulden	VbIn
Dult	SbSgFm
Dummchen	xx
Dumper	xx
Dune	xx
Dune:	SbSgFm
Dung	SbSgMs
Dunger:	SbSgMs
Dunkel:	SbSgMs
Dunne:	SbSgFm
Dunsel	xx
Dunst	SbSgMs
Dups	xx
Dur	SbSgNtMusi
Durer:	NmSurn
Durre:	SbSgFm
Durst	SbSgMs
Dusch/gel	SbSgNt
Dusche	SbSgFm
Duse:	SbSgMs
Dusel	SbSgMs	duseln	VbIn
Dussel	SbSgMsVulg
Dust	xx
Dutt	SbSgMs
Dutte	xx
Dweil	xx
Ebbe	SbSgFm
Eber	SbSgMsZool
Echse	SbSgFmZool
Eck	SbSgNt
Eckchen	SbSgNtDimt	Ecke	SbSgFm
Ecke	SbSgFm
Ecker	xx
Eden	NmGeogBibl
Eder	NmSurn
Edle	SbSgFm
Egel	SbSgMs
Eger	NmGeogFlum
Egge	SbSgFm
Egk	xx
Ehre	SbSgFm
Ei	SbSgNtNutr
Eibe	SbSgFmBota
Eich	xx
Eiche	SbSgFmBota
Eichel	SbSgFm
Eicher	NmSurn
Eid	SbSgMs
Eider	xx
Eifel	SbSgFmGeogRegn
Eifer	SbSgMs
Eifler	NmSurn
Eiger	NmMsGeogMontForg.Ch
Eigne	xx
Eike	NmMsPren
Eile	SbSgFm
Eimer	SbSgMs
Einser	SbSgMsNumr
Eintel	SbSgNtNumr
Einzel	SbSgNt
Eis		SbSgNtMeto
Eisen	SbSgNtMetl
Eiter	SbSgMsMedc
Eiß	xx
Eiße	xx
Ekg	xx
Elbe	NmFmGeogFlum.De
Elch	SbSgMsZool
Elen	NmFmPren
Elfe	SbSgFmPers
Elfer	SbSgMsSpor
Elke	NmFmPren
Elle	SbSgFmMeas
Ellen	SbPlFmMeas	Elle	SbSgFmMeas
Eller	xx
Elm	xx
Els	xx
Else	NmFmPren
Elster	SbSgFmZool
Eltern	SbPlPers
Emd	xx
Emden	NmGeogCity.De
Emder	SbSgMsPersGeogCity.De	Emden	NmGeogCity.De
Emmchen	xx
Emme	xx
Emmer	xx
Empfang	SbSgMs
Ems	NmGeogCity
Emscher	NmFmGeogFlum.De
Emse	xx
Emser	SbSgMsGeogCity.De	Ems	NmGeogCity.De
Endchen	SbSgNtDimt	Ende	SbSgFm
Ende	SbSgFm
Endel	xx
Enge	SbSgFm
Engel	SbSgMs
Enkel	SbSgMs
Enns	xx
Entchen	SbSgNtDimtZool	Ente	SbSgFmZool
Ente	SbSgFmZool
Enter	xx
Enz	NmSurn
Epen	xx
Erbe	SbSgFm
Erbse	SbSgFmNutr
Erde	SbSgFm
Eren	xx
Erft	xx
Erker	SbSgMs
Erle	SbSgFmBota
Ern	xx
Ernte	SbSgFm
Erpel	SbSgMsZool
Erve	xx
Erz	SbSgNtMinr
Esc	xx
Esche	SbSgFmBota
Esel	SbSgMsZool
Espe	SbSgFmBota
Esse	SbSgFm
Esser	SbSgMs	essen	VbIn
Este	SbSgMsPersGeogCtry.Et
Ester	SbSgMsChem
Esther	NmFmPren
Ether	xx
Etsch	NmMsGeogFlumForg.It
Etter	xx
Etzel	xx
Eu	xx
Eugen	NmMsPren
Eule	SbSgFmZool
Euler	NmSurn
Eumel	SbSgMsVulg
Eurer	xx
Euter	SbSgNt
Ewe	xx
Ewer	xx
Fabel	SbSgFm	fabeln	VbIn
Fach	SbSgNt
Facher:	SbSgMs
Fackel	SbSgFm	fackeln	VbIn
Fact	SbSgMsForg.En
Fadchen:	SbSgNtDimt	Faden	SbSgMs
Faden	SbSgMs
Fafner	xx
Fahe:	xx
Fahnchen:	SbSgNtDimt	Fahne	SbSgFm
Fahnder	SbSgMs	fahnden	VbIn
Fahne	SbSgFm
Fahrde:	xx
Fahre:	SbSgFm
Fahrer	SbSgMs	fahren	VbIn
Fahrt	SbSgFm
Fahrte:	SbSgFm	Fahrt	SbSgFm
Faible	SbSgNtForg
Fake	xx
Fakt	SbSgMsForg
Falbe	xx
Falbel	xx
Falk	NmSurn
Falke	SbSgMsZool
Falkner	SbSgMsProf
Fall	SbSgMs	fallen	VbInStrg
Falle	SbSgFm
Falscher:	SbSgMsPers
Falster	xx
Faltchen:	SbSgNtDimt	Falte	SbSgFm
Falte	SbSgFm
Falter	SbSgMs	falten	VbIn
Falz	SbSgMs
Falzer	SbSgMs	falzen	VbIn
Fan	SbSgMsPersForg.En
Fang	SbSgMs
Fanger:	SbSgMs
Farbe	SbSgFm	farben:	VbIn
Farber:	NmSurn
Farce	SbSgFmForg.Fr
Farm	SbSgFm
Farmer	SbSgMsProf	Farm	SbSgFm
Farn	SbSgMsBota
Farre	SbSgMsZool
Farse:	SbSgFmZool
Fasche	xx
Fase	xx
Fasel	xx
Faser	SbSgFm
Fasler	SbSgMsPers
Fass	SbSgNt
Fasschen:	SbSgNtDimt	Fass	SbSgNt
Fatzke	SbSgMsPersVulg
Faule:	SbSgFm
Faulkner	xx
Faun	SbSgMsPers
Faust	SbSgFmBody
Faustchen:	SbSgNtDimtBody	Faust	SbSgFmBody
Faustel:	SbSgMs
Fax	SbSgMs
Faxe	SbPl	Fax	SbSgMs
Feber	xx
Fechser	xx
Fechter	SbSgMs	fechten	VbIn
Feder	SbSgFm
Fee	SbSgFmPers
Feet	xx
Fege	xx
Feger	SbSgMs	fegen	VbIn
Fegsel	xx
Feh	xx
Fehde	SbSgFm
Fehler	SbSgMs	fehlen	VbIn
Fehn	xx
Feier	SbSgFm	feien	VbIn
Feile	SbSgFm
Feim	xx
Feime	xx
Feimen	xx
Feind	SbSgMs
Feine	xx
Feiste	xx
Feitel	xx
Felbel	xx
Felber	xx
Felchen	SbSgMsZool
Feld	SbSgNt
Feldscher	SbSgMsProf
Felge	SbSgFm
Fell	SbSgNt
Fels	SbSgMs
Felsen	SbPlAc	Fels	SbSgMs
Feme	SbSgFm
Femel	xx
Fench	xx
Fenchel	SbSgMsNutr
Fender	xx
Fenn	xx
Fenster	SbSgNt
Fenz	xx
Ferdl	xx
Ferge	xx
Fergger	xx
Ferkel	SbSgNt	ferkeln	VbIn
Ferse	SbSgFmBody
Fersler	xx
Fessel	SbSgFm	fesseln	VbIn
Feste	SbSgFm
Fete	SbSgFmForg.Fr
Fette	SbPlNutr	Fett	SbSgNtNutr
Fetzchen	SbSgNtDimt	Fetzen	SbSgMs
Feuchte	SbSgFm
Feudel	xx
Feuer	SbSgNt
Fex	xx
Fez	SbSgMsForg
Fibel	SbSgFm
Fiber	SbSgNtForg.En
Fiche	SbSgMsForg
Fichte	SbSgFmBota
Fick	SbSgMsVulg
Fieber	SbSgNtMedc
Fiedel	SbSgFm	fiedeln	VbIn
Fiedler	NmSurn
Fight	SbSgMsForg.En
Fighter	SbSgMsForg	fighten	VbInForg
Figl	xx
File	SbSgNtForg
Film	SbSgMs
Fils	xx
Filter	SbSgMs
Filz	SbSgMs
Fimmel	SbSgMs
Finder	SbSgMs	finden	VbIn
Finger	SbSgMsBody
Fink	SbSgMs
Finken	SbPlAc	Fink	SbSgMs
Finne	SbSgMsPersGeogCtry.Fi	Finnland	NmGeogCtry.Fi
Finte	SbSgFm
Fips	SbSgMsVulg
Firne	xx
First	SbSgMs
Firth	xx
Fisch	SbSgMsZool
Fischer	SbSgMs	fischen	VbIn
Fistel	SbSgFm	fisteln	VbIn
Fitsche	xx
Fitz	SbSgMs
Fitzchen	xx
Fitze	xx
Fitzel	SbSgMs
Fixer	SbSgMs	fixen	VbIn
Fjall:	xx
Fjell	xx
Fjord	SbSgMsForg
Flab	xx
Flache:	SbSgFm
Flachs	SbSgMs
Flachse	SbSgFm
Fladen	SbSgMs
Flader	xx
Fladle:	SbSgNtNutr
Flagge	SbSgFm
Flair	SbSgNtForg
Flak	SbSgFmAbbrMilt	Flugabwehrkanone	SbSgFmMilt	
Flake	xx
Flame	xx
Flammchen:	SbSgNtDimt	Flamme	SbSgFm
Flamme	SbSgFm
Flanke	SbSgFm
Flansch	SbSgMs
Flappe	xx
Flaps	SbSgMsVulg
Flaschchen:	SbSgNtDimt	Flasche	SbSgFm
Flasche	SbSgFm
Flaschner	SbSgMsProf
Flaser	xx
Flatsche	xx
Flatschen	SbSgMsVulg
Flatter	xx
Flaum	SbSgMs
Flaumer	xx
Flaus	xx
Flausch	SbSgMs
Flause	SbSgFm
Flausen	SbPl	Flause	SbSgFm
Flaute	SbSgFm
Flaz:	xx
Flebbe	xx
Flechse	xx
Flechte	SbSgFm	flechten	VbInStrg
Flechter	SbSgMs	flechten	VbIn
Fleck	SbSgMs
Fleckchen	SbSgNtDimt	Fleck	SbSgMs
Flecke	xx
Fleece	SbSgNtClthForg.En
Fleet	xx
Flegel	SbSgMs	flegeln	VbIn
Fleisch	SbSgNt
Fleischer	SbSgMsProf
Fleiß	SbSgMs
Fleppe	xx
Flett	xx
Flettner	xx
Fletz	xx
Fleur	xx
Flic	xx
Flicker	SbSgMs	flicken	VbIn
Flieder	SbSgMsBota
Fliege	SbSgFmZool
Flieger	SbSgMs	fliegen	VbIn
Fliese	SbSgFm
Fließ	xx
Flimmer	xx
Flint	SbSgMsMinr
Flinte	SbSgFm
Flinz	xx
Flip	xx
Flipper	SbSgMsForg.En
Flirt	SbSgMsForg.En
Flittchen	SbSgFmDimt
Flitter	SbSgMs
Flitz	xx
Flitzer	SbSgMs	flitzen	VbIn
Flocke	SbSgFm
Flodel:	xx
Flom	xx
Flomen	xx
Flop	SbSgMsForg.En
Flor	SbSgMs
Floskel	SbSgFm
Flosse	SbSgFm
Flote:	SbSgFm
Flotte	SbSgFm
Floz:	SbSgMs
Floßer:	SbSgMsProf
Fluch	SbSgMs
Flucher	SbSgMs	fluchen	VbIn
Flucht	SbSgMs	fliehen	VbInStrg
Flue:	xx
Flug	SbSgMs	fliegen	VbInStrg
Flugel:	SbSgMs
Fluh	xx
Fluke	xx
Flunder	SbSgFmZool
Flunsch	SbSgMs
Fluppe	SbSgFmVulg
Flur	SbSgMs
Fluse	SbSgFm
Fluss	SbSgMs
Flusschen:	SbSgNtDimt	Fluss	SbSgMs
Flut	SbSgFm
Fock	xx
Fohn:	SbSgMsMeto
Fohr:	NmGeogRegn.De
Fohre:	SbSgFmBota
Folder	SbSgMsForg.En
Folge	SbSgFm
Folk	SbSgForg
Folke	xx
Folter	SbSgFm
Fon	SbSgNt
Fond	SbSgMsForg.Fr
Fonds	SbSgMsForg.En
Font	SbSgMsForg.En
Fopper	SbSgMs	foppen	VbIn
Forde:	SbSgFm
Fore:	xx
Forke	xx
Forle	xx
Form	SbSgFm
Formel	SbSgFm
Former	SbSgMs	formen	VbIn
Forsche	xx
Forscher	SbSgMs	forschen	VbIn
Forst	SbSgMs
Forster:	SbSgMsProf
Fose	xx
Fotze	SbSgFmVulg
Fotzel:	xx
Fox	NmSurnForg.En
Foße	xx
Fra	xx
Fracht	SbSg
Frachter	SbSgMs	Fracht	SbSg
Frachter:	xx
Frack	SbSgMs
Frage	SbSgFm
Frager	SbSgMs	fragen	VbIn
Fragner	xx
Fraisen	xx
Frame	SbSgMsForg.En
Franc	SbSgMsCurrForg
France	NmGeogCtry.Fr
Francke	NmSurn
Franke	SbSgMsGeogRegn.De
Franken	NmGeogRegn.De	Franke	SbSgMsGeogRegn.De
Franken	SbSgMsCurrForg.Ch
Frans	xx
Franse	SbSgFm
Franz	NmMsPren
Franzer	xx
Frase:	SbSgFm
Fraser:	SbSgMs
Frate	xx
Frater	SbSgMsPers
Fratz	SbSgMsPers
Fratzchen:	SbSgNtDimtPers	Fratz	SbSgMsPers
Fratze	SbSgFm
Frauchen	SbSgFmPersDimt	Frau	SbSgFmPers
Frauke	NmFmPren
Fraß	SbSgMs	fressen	VbInStrg
Fred	NmMsPren
Freeze	xx
Freie	xx
Freier	SbSgMs	freien	VbIn
Freite	xx
Fremde	SbSgFm
Freske	SbSgFm
Fresse	SbSgFmVulg
Fresser	SbSgMs	fressen	VbIn
Frettchen	SbSgNtZool
Freud	NmSurn
Freude	SbSgFm
Freund	SbSgMsPers
Freundchen	SbSgNtDimtPers	Freund	SbSgMsPers
Frevler	SbSgMs
Friede	SbSgMs
Friedel	NmMsPrenDimt
Frieder	NmMsPren
Fries	SbSgNt
Friese	SbSgMsPers	Friesland	NmGeogRegn
Friesel	xx
Friesland	NmGeogRegn
Frigg	xx
Frische	SbSgFm
Frist	xx
Fritte	xx
Fritz	NmMsPren
Frobel:	xx
Fromme	xx
Frommler:	xx
Fron	SbSgFm
Fronde	xx
Froner:	xx
Front	SbSgFm
Frosch	SbSgMsZool
Froschchen:	SbSgNtDimtZool	Frosch	SbSgMsZool
Frost	SbSgMs
Froster	SbSgMs	frosten	VbIn
Frucht	SbSgFmNutr
Fruchtchen:	SbSgNtDimtPers	Frucht	SbSgFmNutr
Fruhchen:	SbSgNtDimtPers
Fruhe:	SbSgFm
Frust	SbSgMsForg.En
Fuchs	SbSgMsZool
Fuchschen:	SbSgNtDimtZool	Fuchs	SbSgMsZool
Fuchtel	SbSgFm	fuchteln	VbIn
Fuder	xx
Fug	SbSgMs
Fuge	SbSgFm
Fugger	NmSurn
Fuhler:	SbSgMs
Fuhre	SbSgFm
Fuhre:	xx
Fuhrer:	SbSgMsPers
Fulbe	xx
Fulle:	SbSgFm
Fuller:	SbSgMs
Fullsel:	SbSgNt
Fummel	SbSgMs	fummeln	VbIn
Fun	SbSgMsForg.En
Fund	SbSgMs	finden	VbInStrg
Funen:	xx
Funfer:	SbSgMs
Funk	SbSgMs
Funkchen:	SbSgNtDimt	Funke	SbSgMs
Funke	SbSgMs
Funker	SbSgMs	funken	VbIn
Funzel	SbSgFm
Furche	SbSgFm
Furcht	SbSgFm
Furst:	SbSgMsPers
Furt	SbSgFm
Furth:	NmGeogCity.De
Furz	SbSgMs
Furzchen:	SbSgNtDimt	Furz	SbSgMs
Fusel	SbSgMs	fuseln	VbIn
Fussel	SbSgMs	fusseln	VbIn
Fussen:	NmGeogCity.De
Futter	SbSgNt
Fuzel	xx
Fuß	SbSgMs
Fußchen:	SbSgNtDimt	Fuß	SbSgMs
Ga	xx
Gabe	SbSgFm	gehen	VbInStrg
Gabel	SbSgFm	gabeln	VbIn
Gabler	xx
Gad	xx
Gaden	xx
Gaffel	xx
Gaffer	SbSgMs	gaffen	VbIn
Gag	SbSgMsForg
Gage	SbSgFm
Gale:	xx
Galen	xx
Galgen	SbSgMs
Galle	SbSgFm
Gambe	SbSgFmMusi
Gammel	SbSgMs	gammeln	VbIn
Gammler	SbSgMs
Gams	SbSgFmZool
Gamse:	SbSgFmZool	Gams	SbSgFmZool
Gand	xx
Gangster	SbSgMsPers
Gans	SbSgFmZool
Ganschen:	SbSgNtDimtZool	Gans	SbSgFmZool
Ganser	xx
Gant	xx
Ganter	SbSgMsZool
Ganze:	SbSgFm	ganz	Aj
Garbe	SbSgFm
Garde	SbSgFmForg.Fr
Gare	xx
Garn	SbSgNt
Gartchen:	SbSgNtDimt	Garten	SbSgMs
Garten	SbSgMs
Gartner:	SbSgMsProf
Gas	SbSgNt
Gasel	xx
Gasschen:	SbSgNtDimt	Gasse	SbSgFm
Gasse	SbSgFm
Gast	SbSgMsPers
Gat	xx
Gate	SbSgNtForg.En
Gatsch	xx
Gatt	xx
Gatte	SbSgMsPers
Gatter	SbSgNt
Gau	SbSgMs
Gau:	xx
Gaube	SbSgFm
Gauch	xx
Gaukler	SbSgMs
Gaul	SbSgMsZool
Gaulchen:	SbSgNtDimtZool	Gaul	SbSgMsZool
Gaulle	NmSurnForg.Fr
Gault	xx
Gaumen	SbSgMsBody
Gauner	SbSgMsPers
Gaupe	xx
Gaur	xx
Gautsche	xx
Gautscher	SbSgMs	gautschen	VbIn
Gauß	NmSurn
Gaze	SbSgFmForg.Fr
Geber	SbSgMs	geben	VbIn
Gebot	SbSgNt
Geburt	SbSgFm
Gebäck	SbSgNt
Geck	SbSgMsPers
Gedanke	SbSgMs
Geest	xx
Gefecht	SbSgNt
Gegner	SbSgMs	gegnen	VbIn
Geher	SbSgMs	gehen	VbIn
Gehlchen	xx
Gehre	SbSgFm
Gei	xx
Geier	SbSgMsZool
Geifer	SbSgMs
Geige	SbSgFmMusi
Geiger	SbSgMs	geigen	VbIn
Geile	SbSgFm
Geisel	SbSgFm
Geiser	xx
Geist	SbSgMs
Geiz	SbSgMs
Geiß	xx
Geißel	SbSgFm	geißeln	VbIn
Geißler	NmSurn
Gelbe	xx
Geld	SbSgNt
Gelse	xx
Gelze	xx
Gemme	SbSgFm
Gemse	SbSgFmZool
Genf	NmGeogCityForg.Ch
Genfer	SbSgMsGeogCityForg.Ch	Genf	NmGeogCityForg.Ch
Genre	SbSgNtForg.Fr
Gent	NmGeogCityForg.Be
Genuss	SbSgMs
Gerber	SbSgMs	gerben	VbIn
Gerd	NmMsPren
Germ	SbSgMsNutr
Germer	xx
Gerste	SbSgFmNutr
Gerstl	xx
Gert	xx
Gerte	SbSgFm
Gertel	xx
Geruch	SbSgMs
Gese	xx
Gesicht	SbSgNtBody
Gest	xx
Gestank	SbSgMs	stinken	VbIn
Geste	SbSgFm
Geuse	xx
Gewerbe	SbSgMs
Gewinn	SbSgMs
Geßner	xx
Gfrast	xx
Gfrett	xx
Gfrieß	xx
Ghasel	xx
Gicht	SbSgFmMedc
Gickel	xx
Gide	NmSurnForg.Fr
Giebel	SbSgMs
Giemen	xx
Gien	xx
Gieper	xx
Gier	SbSgFm
Giersch	xx
Gießer	SbSgMs	gießen	VbIn
Gift	SbSgNt
Giftler	xx
Gig	xx
Gilb	SbSgMs	gelb	Aj
Gilde	SbSgFm
Gimpe	xx
Gimpel	SbSgMs
Gin	SbSgMsNutr
Ginger	SbSgMsNutrForg.En
Ginster	SbSgMsBota
Gipfel	SbSgMs	gipfeln	VbIn
Gips	SbSgMs
Gipser	SbSgMs	gipsen	VbIn
Girl	SbSgNtPersForg.En
Gischt	SbSgFm
Gise	xx
Gitte	NmFmPren
Gitter	SbSgNt
Glace	SbSgFmForg.Fr
Glans	xx
Glanz	SbSgMs
Glarner	SbSgMsPersGeogRegnForg.Ch	Glarus	NmGeogRegnForg.Ch
Glas	SbSgNt
Glaschen:	SbSgNtDimt	Glas	SbSgNt
Glaser	SbSgMs	glasen	VbIn
Glast	SbSgMs
Glatte:	SbSgFm	glatt	Aj
Glatze	SbSgFmBody
Glaube	SbSgMs	glauben	VbIn
Gleiche	SbSgFm
Gleis	SbSgNt
Gleisner	SbSgMsPers
Gleiter	SbSgMs	gleiten	VbIn
Gleiße	xx
Gletscher	xx
Gleve	xx
Glibber	SbSgMs
Glied	SbSgNt
Glimmer	SbSgMsMinr
Glitsche	xx
Glitzer	SbSgMs
Glockchen:	SbSgNtDimt	Glocke	SbSgFm
Glocke	SbSgFm
Glockner:	SbSgMsProf
Glosse	SbSgFm
Glotze	SbSgFmVulg
Gluck	xx
Gluck:	SbSgNt
Glucke	SbSgFm
Glumse	xx
Glut	SbSgFm
Gluten	SbPlNutr
Gmund:	NmGeogCity.De
Gmunden	xx
Gnade	SbSgFm
Gnatz	xx
Gneis	SbSgMsMinr
Gnitte	xx
Gnitze	xx
Gnom	SbSgMs
Gnome	SbPl	Gnom	SbSgMs
Gnu	SbSgNtZool
Go	SbSgNt
Gockel	SbSgMs
God:	xx
Gode	xx
Godel	xx
Goden	xx
Goder	xx
Godl	xx
Goes	xx
Goethe	NmSurn
Gof	xx
Gog	xx
Gogh	NmSurn
Gold	SbSgNtMetl
Golf	SbSgMs
Golfer	SbSgMs	golfen	VbIn
Goller:	xx
Gondel	SbSgFm	gondeln	VbIn
Gong	SbSgMs
Gonner:	SbSgMsPers
Gopel:	SbSgMs
Gor:	SbSgNtPers
Gore:	SbSgFmPers
Gorz:	xx
Gosch:	xx
Gosche	SbSgFmVulg
Gose	xx
Gospel	SbSgNtForg
Gosse	SbSgFm
Gossel:	xx
Gote	SbSgMsPers
Gott	SbSgMs
Gotte	SbSgMsPers
Gotz:	NmSurn
Gotze:	SbSgMsPers
Grab	SbSgNt
Grabbe	xx
Grabchen:	SbSgNtDimt	Graben	SbSgMs
Graben	SbSgMs
Graber:	SbPl	Grab	SbSgNt
Grabscher	SbSgMs	grabschen	VbIn
Gracche	xx
Gracht	SbSgFm
Grad	SbSgMs
Gradel	xx
Gradl	xx
Graf	SbSgMsPers
Graffel	xx
Grain	xx
Gral	SbSgMs
Gramm	xx
Grammel	xx
Gran	SbSgNtMeas
Gran:	xx
Grand	SbSgMs
Grande	SbSgMsPers
Grandel	xx
Grane:	xx
Granne	SbSgFmBota
Grant	SbSgMs
Grantler	SbSgMs
Graph	SbSgMs
Grapscher	SbSgMs	grapschen	VbIn
Gras	SbSgNtBota
Graschen:	SbSgNtDimt	Gras	SbSgNtBota
Graser	SbSgMs	grasen	VbIn
Grass	NmSurn
Grat	SbSgMs
Grate:	SbSgFm	Grat	SbSgMs
Gratsche:	xx
Gratzel:	xx
Grauchen	xx
Grauel:	SbPl
Graupe	SbSgFmNutr
Graupel	SbSgMs	graupeln	VbIn
Graz	NmGeogCityForg.At
Grazer	SbSgMsGeogCityForg.At	Graz	NmGeogCityForg.At
Greene	NmSurnForg.Us
Greif	SbSgMsZool
Greifer	SbSgMs	greifen	VbIn
Greißler	xx
Grelle	SbSgFm
Grenze	SbSgFm
Grenzer	SbSgMs	grenzen	VbIn
Gret	NmFmPrenAbbr
Gretchen	NmFmPrenDimt
Grete	NmFmPren
Gretel	NmFmPrenDimt
Greuel	SbPl
Griebe	xx
Griebs	xx
Grieche	SbSgMsPersGeogCtry.Gr	Griechenland	NmGeogCtry.Gr
Griefe	xx
Grieg	xx
Grieß	SbSgMsNutr
Griff	SbSgMs	greifen	VbInStrg
Griffel	SbSgMs
Grill	SbSgMs
Grille	SbSgFmZool
Grimm	SbSgMs
Grimsel	NmGeogMontForg.Ch
Grind	SbSgMsBody
Grip	SbSgMsForg.En
Grippe	SbSgMsMedc
Grips	SbSgMs
Grit	xx
Gritt	xx
Grobe:	xx
Groden	xx
Grog	SbSgMsNutr
Groll	SbSgMs
Groppe	xx
Gros	SbSgNt
Groschen	SbSgMsCurr
Grostl:	SbSgNtNutrDial
Grosz	NmSurn
Grotte	SbSgFm
Grotzen	xx
Große:	SbSgFm
Grubber	xx
Grubchen:	SbSgNtDimt	Grube	SbSgFm
Grube	SbSgFm
Grubler:	xx
Grude	xx
Gruft	SbSgFm
Grumt	xx
Grund	SbSgMs
Grundel	xx
Grundel:	xxDiar
Grunder:	SbSgMsPers
Grune:	SbSgFm	grun:	AjColr
Grunge	xx
Grupp	xx
Gruppchen:	SbSgNtDimt	Gruppe	SbSgFm
Gruppe	SbSgFm
Gruppe:	xx
Grus	xx
Grusel	SbSgMs	gruseln	VbIn
Grutze:	SbSgFm
Gruß	xx
Gscherte	xx
Gschnas	xx
Gstaad	xx
Gstanzl	xx
Gstatten:	xx
Gucker	SbSgMs	gucken	VbIn
Guelfe	xx
Guggel:	xx
Gulden	SbSgMsCurr
Gulle:	SbSgFm
Gult:	xx
Gulte:	xx
Gumpe	xx
Gunsel:	xx
Gunst	SbSgFm
Gunter:	NmMsPren
Gunther	NmMsPren
Gunther:	NmMsPrenDiar
Gupf	xx
Gur	xx
Gurgel	SbSgFm	gurgeln	VbIn
Gurkchen:	SbSgNtDimtNutr	Gurke	SbSgFmNutr
Gurke	SbSgFmNutr
Gurt	SbSgMs
Gurte	SbPl	Gurt	SbSgMs
Gurtel:	SbSgMs
Gurtler:	xx
Gusche	xx
Gusel:	xx
Guss	SbSgMs	gießen	VbInStrg
Guste	xx
Gustel	NmFmPrenDimt
Guster:	xx
Gutchen:	xx
Gute:	xx
Gutsel	xx
Gwirkst	xx
Haag	NmGeogCityForg.Nl
Haager	SbSgMsGeogCityForg.Nl	Haag	NmGeogCityForg.Nl
Haar	SbSgNtBody
Haard	xx
Haardt	xx
Habe	SbSgFm
Haber	xx
Hachel	xx
Hachse	SbSgFmNutr
Hack	SbSgMsForg
Hacke	SbSgFm
Hacker	SbSgMs	hacken	VbIn
Hacksel:	SbSgNt	hacken	VbIn
Hacksler:	SbSgMs	hacken 	VbIn
Haddsch	SbSgFmForg.Ar
Hader	SbSgMs
Hadrer	xx
Hadsch	xx
Haeckel	NmSurn
Hafen	SbSgMs
Hafen:	SbPl	Hafen	SbSgMs
Hafer	SbSgMsNutr
Haff	SbSgNtGeog
Hafner	SbSgMsProf
Hafner:	NmSurnDiar
Haft	SbSgFm
Haftel	SbSgNt
Hag	SbSgMs
Hagel	SbSgMs	hageln	VbIn
Hagen	NmGeogCity.De
Haher:	xx
Hahn	SbSgMsZool
Hahnchen:	SbSgNtDimtNutr	Hahn	SbSgMsZool
Hahnen	xx
Hai	SbSgMsZool
Hain	SbSgMs
Hakchen:	SbSgNtDimt	Haken	SbSgMs
Halbe	SbSgFmNutr
Halde	SbSgFm
Halfte:	SbSgFm
Halfter	SbSgMs
Hall	SbSgMs
Halle	NmGeogCity.De
Haller	NmSurn
Halm	SbSgMs
Hals	SbSgMsBody
Halse	SbSgFm
Halt	SbSgMs	halten	VbInStrg
Halter	SbSgMs	halten	VbIn
Ham	xx
Hame:	SbSgFm
Hamen	xx
Hamm	NmGeogCity.De
Hammel	SbSgMsZool
Hammer	SbSgMs
Hamster	SbSgMsZool
Hand	SbSgFmBody
Handchen:	SbSgNtDimtBody	Hand	SbSgFmBody
Handel	SbSgMs
Handel:	SbPl	Handel	SbSgMs
Handke	NmSurn
Handler:	SbSgMsProf	Handel	SbSgMs
Hands	xx
Hanf	SbSgMsBota
Hang	SbSgMs
Hanger:	SbSgMs	hangen:	VbIn
Hanne	NmFmPren
Hans	NmMsPren
Hanschen:	NmNtPrenDimt	Hans	NmMsPren
Hanse	SbSgFm
Hansel	NmMsPrenDimt
Hansel:	NmMsPrenDimt	Hans	NmMsPren
Hantel	SbSgFm	hanteln	VbIn
Happchen:	SbSgNtDimt	Happen	SbSgMs
Happs	xx
Harchen:	SbSgNtDimtBody	Haar	SbSgNtBody
Harde	xx
Hardt	NmSurn
Harfe	SbSgFmMusi
Harfner	xx
Harke	SbSgFm
Harm	xx
Harn	SbSgFmBody
Harst	xx
Harte	xx
Harte:	SbSgFm	hart	Aj
Harter:	SbSgMs	harten:	VbIn
Harz	SbSgNt
Harz	NmMsGeogRegn
Harzer	SbSgMs	harzen	VbIn
Hasch	SbSgMs
Hascher	xx
Hascher:	SbSgMsPers
Hase	SbSgMsZool
Hasel	SbSgFm
Haspe	xx
Haspel	SbSgFm	haspeln	VbIn
Haspen	xx
Hass	SbSgMs
Hasser	SbSgMs	hassen	VbIn
Hast	SbSgFm
Hatscher	xx
Hatz	SbSgFm
Hau	SbSgMs
Haubchen:	SbSgNtDimt	Haube	SbSgFm
Haube	SbSgFm
Hauch	SbSgMs
Haue	SbSgFm
Hauer	SbSgMsProf
Hauer:	xx
Haufchen:	SbSgNtDimt	Haufen	SbSgMs
Haufe	SbSgMs
Haufen	SbSgMs
Hauff	NmSurn
Hauke	xx
Haupt	SbSgNtBody
Hauptel:	xx
Haus	SbSgNt
Hauschen:	SbSgNtDimt	Haus	SbSgNt
Hausel:	SbSgNtDimtDial
Hauser	NmSurn
Hausl:	xx
Hausler:	SbSgMsPers
Hausse	SbSgFmForg.Fr
Haut	SbSgFm
Havel	NmFmGeogFlum
Haxe	SbSgFmNutr
Haxl	xx
Hebbel	NmSurn
Hebe	SbSgFm
Hebel	SbSgMs	hebeln	VbIn
Heber	SbSgMs	heben	VbIn
Hechel	xx
Hecht	SbSgMsZool
Heck	xx
Hecke	SbSgFm
Hede	xx
Heer	SbSgNtMilt
Hefe	SbSgFmNutr
Heft	SbSgNt
Heftel	xx
Hefter	SbSgMs	heften	VbIn
Hege	xx
Hegel	NmSurn
Heger	SbSgMs	hegen	VbIn
Hehl	SbSgNt
Hehler	SbSgMs	hehlen	VbIn
Heide	SbSgMsPers
Heiden	SbPlPers	Heide	SbSgMsPers
Heidjer	xx
Heike	NmFmPers
Heiler	SbSgMs	heilen	VbIn
Heim	SbSgNt
Heimchen	SbSgNtDimt	Heim	SbSgNt
Hein	NmMsPren
Heine	NmSurn
Heiner	NmMsPren
Heinz	NmMsPren
Heinze	NmSurn
Heister	xx
Heizer	SbSgMs	heizen	VbIn
Held	SbSgMs
Helder	xx
Helfe	xx
Helfer	SbSgMs	helfen	VbIn
Helge	NmMsPren
Helgen	xx
Helke	xx
Heller	SbSgMs
Helm	SbSgMsMilt
Hemd	SbSgNt
Hendl	SbSgNtNutrDial
Hengst	SbSgMsZool
Henkel	NmSurn
Henker	SbSgMs	henken	VbIn
Henne	SbSgFmZool
Henze	xx
Herbe	xx
Herbst	SbSgMsTime
Herd	SbSgMs
Herde	SbSgFm
Herder	NmSurn
Herme	xx
Herr	SbSgMsPers
Herrchen	SbSgNtDimtPers	Herr	SbSgMsPers
Herrscher	SbSgMs	herrschen	VbIn
Herschel	NmSurn
Hertz	NmSurn
Herz	SbSgNtBody
Herzchen	SbSgNtDimt	Herz	SbSgNtBody
Herze	xx
Hesse	SbSgMsGeogRegn
Hessen	NmGeogRegn	Hesse	SbSgMsGeogRegn
Hetz	xx
Hetze	SbSgFm
Hetzer	SbSgMs	hetzen	VbIn
Heu	SbSgNtBota
Heuchler	SbSgMs
Heuler	SbSgMs	heulen	VbIn
Heuss	NmSurn
Hexe	SbSgFmPers
Hexer	SbSgMs	hexen	VbIn
Hieb	SbSgMs	hauen	VbInStrg
Hiefe	xx
Hilfe	SbSgFm	helfen	VbInStrg
Hilke	xx
Himmel	SbSgMs	himmeln	VbIn
Hinde	xx
Hinkel	NmSurn
Hinz	NmSurn
Hippe	xx
Hirn	SbSgNtBody
Hirsch	SbSgMsZool
Hirse	SbSgFmNutr
Hirt	SbSgMs
Hirte	SbSgMs
Hit	SbSgMsForg.En
Hitsche	xx
Hitze	SbSgFm	heiß	Aj
Ho	xx
Hobel	SbSgMs	hobeln	VbIn
Hobler	SbSgMs
Hock	SbSgMs
Hock:	xx
Hocke	SbSgFm
Hocker	SbSgMs
Hocker:	SbSgMsBodyDiar
Hode	xx
Hoden	SbPl
Hoden	SbSgMs
Hodler	xx
Hodr:	xx
Hof	SbSgMs
Hoft:	xx
Hohe:	SbSgFm	hoch	Aj
Hohle:	SbSgFm	hohl	Aj
Hohn	SbSgMs
Hoker:	xx
Holder	xx
Holger	NmMsPren
Holk	xx
Holle	NmSurn
Holle:	SbSgFm
Holler	SbSgMs
Holler:	xx
Holm	SbSgMs
Holste	xx
Holster	SbSgNt
Holz	SbSgNt
Holzchen:	SbSgNtDimt	Holz	SbSgNt
Holzer	NmSurn
Homer	NmSurnForg.Gr
Hopser	SbSgMs	hopsen	VbIn
Horcher	SbSgMs	horchen	VbIn
Horde	SbSgFm
Hore	xx
Horen	xx
Horer:	SbSgMsPers
Horn	SbSgNt
Hornchen:	SbSgNtDimt	Horn	SbSgNt
Horsel:	xx
Horst	NmMsPren
Hort	SbSgMs
Hoschen:	SbSgNtDimt	Hose	SbSgFm
Hose	SbSgFm
Host	SbSgMsForg.En
Hot	xx
Hotel	SbSgNtForg
Hotte	xx
Hotter	xx
Hoxter:	NmSurn
Hub	SbSgMs
Hubbel	SbSgMs
Hube	xx
Huber	NmSurn
Hubner:	NmSurn
Huch	Rp
Huchen	xx
Hucke	SbSgFm
Hude	xx
Hudel	xx
Hudler	SbSgMs
Huf	SbSgMs
Hufe	SbPl	Huf	SbSgMs
Hufner	SbSgMsProf
Hufner:	xxDiar
Hufte:	SbSgFmBody
Hugel:	SbSgMs
Huhn	SbSgNtZool
Huhnchen:	SbSgNtDimtZool	Huhn	SbSgNtZool
Huker	xx
Hulbe:	xx
Huld	SbSgFm
Hulk	xx
Hulle:	SbSgFm
Hulschen:	xx
Hulse:	SbSgFm
Hume	xx
Hummel	SbSgFmZool
Hummer	SbSgMsZool
Humpel:	xx
Humpen	SbSgMs
Hund	SbSgMsZool
Hundchen:	SbSgNtDimtZool	Hund	SbSgMsZool
Hune:	SbSgMsPers
Hunger	SbSgMs
Hunne	SbSgMsPers
Hunt	xx
Hunter	SbSgMsProfForg.En
Hupe	SbSgFm
Hupf	xx
Hupfer	SbSgMsDial
Hupfer:	SbSgMsDiar
Hurde	xx
Hurde:	SbSgFm
Hure	SbSgFmPers
Hus	xx
Husch	xx
Husche	xx
Husse	xx
Hut	SbSgMs
Hutchen:	SbSgNtDimt	Hut	SbSgMs
Huter:	SbSgMsPers
Hutsche	xx
Hutsche:	xxDiar
Huttchen:	SbSgNtDimt	Hutte:	SbSgFm
Hutte	xx
Hutte:	SbSgFm
Hutten	xx
Hutten:	SbPl	Hutte:	SbSgFm
Hutze	xx
Hutzel	SbSgFm
Ibn	NmMsPrenForg.Ar
Ibsen	NmSurn
Iden	xx
Igel	SbSgMsZool
Ihle	xx
Ijssel	xx
Iler	xx
Ill	NmGeogFlumForg.Fr
Iller	NmFmGeogFlum
Ilm	xx
Ilse	NmFmPren
Imke	xx
Imker	SbSgMsProf
Imme	SbSgFmZool
Imp	xx
Imst	xx
Inch	SbSgMsMeasForg.Us
Inder	SbSgMsPersGeogCtry.In	Indien	NmGeogCtry.In
Infel	xx
Inge	NmFmPren
Ingwer	SbSgMsNutrForg
Inn	NmGeogFlum.De
Insel	SbSgFm
Inste	xx
Ir	xx
Ire	SbSgMsPersGeogCtry.Ie	Irland	NmGeogCtry.Ie
Ische	xx
Ischl	xx
Isel	xx
Iser	xx
Jab	xx
Jacht	xx
Jack	xx
Jackchen:	SbSgNtDimt	Jacke	SbSgFm
Jacke	SbSgFm
Jade	SbSgNtMinr
Jagd	SbSgFm
Jager:	SbSgMsProf	Jagd	SbSgFm
Jagst	NmGeogFlum.De
Jahe:	xx
Jahn	NmSurn
Jahnn	xx
Jahr	SbSgNt
Jahrchen:	SbSgNtDimt	Jahr	SbSgNt
Jahve	xx
Jahwe	NmBibl
Jak	xx
Jam	xx
Jambe	xx
Jammer	SbSgMs
Jan	NmMsPren
Jane	xx
Jangtse	NmMsGeogFlum.Cn
Janker	SbSgMs
Janner:	SbSgMsDialTimeMnth.1
Japser	SbSgMs	japsen	VbIn
Jass	xx
Jasser	xx
Jauche	SbSgFm
Jauchzer	SbSgMs	jauchzen	VbIn
Jaunde	xx
Jause	SbSgFmDial
Jazz	SbSgMsForg.En
Jazzer	SbSgMsForg.En	jazzen	VbIn
Jemen	NmGeogCtry
Jens	NmMsPren
Jet	SbSgMsForg.En
Jett	xx
Jeu	xx
Jever	NmGeogCity.De
Jieper	xx
Jim	NmMsPrenForg.Us
Jingle	SbSgNtForg
Jive	xx
Job	SbSgMsForg.En
Jobber	SbSgMsForg	jobben	VbIn
Jobst	xx
Joch	SbSgNt
Jod	SbSgNtChem
Jodel	SbSgMs	jodeln	VbIn
Jodler	SbSgMs
Joel	xx
Jogger	SbSgMsForg	joggen	VbIn
John	NmMsPrenForg.En
Joker	SbSgMsForg
Jolle	SbSgFm
Joppe	SbSgFm
Jorg:	NmMsPren
Jorn:	xx
Jost	xx
Jot	xx
Jubel	SbSgMs	jubeln	VbIn
Juchhe	Rp
Juchzer	SbSgMs	juchzen	VbIn
Jucker	xx
Jude	NmPersGeogRegn
Jumper	SbSgMsForg	jumpen	VbIn
Jungchen	SbSgNtDimtPers	Junge	SbSgMsPers
Junge	SbSgMsPers
Junger:	SbSgMsPers	jung	Aj
Jungfer	SbSgFmPersAbbr	Jungfrau	SbSgFm
Junker	SbSgMsPers
Jupe	xx
Jupp	NmMsPren
Jurgen:	NmMsPren
Jurte	xx
Jus	xx
Jute	SbSgFm
Jute:	xx
Jutte	xx
Juwel	SbSgNt
Jux	SbSgMs
Juxte	xx
Kabel	SbSgNt	kabeln	VbIn
Kachel	SbSgFm	kacheln	VbInStrg
Kacke	SbSgMsVulg
Kacker	SbSgMs	kacken	VbIn
Kader	SbSgMs
Kafer:	SbSgMsZool
Kaff	SbSgNtVulg
Kaffer	SbSgMsGeogRegn	Kaff	SbSgNtVulg
Kahm	xx
Kahn	SbSgMs
Kahnchen:	SbSgNtDimt	Kahn	SbSgMs
Kai	SbSgNt
Kain	NmMsPren
Kaiser	SbSgMsProf
Kaizen	xx
Kaje	xx
Kak	xx
Kalb	SbSgNtZool
Kalbchen:	SbSgNtDimtZool	Kalb	SbSgNtZool
Kalbe	xx
Kalk	SbSgMs
Kalle	xx
Kalme	xx
Kalte:	SbSgFm	kalt	Aj
Kalter	xx
Kamel	SbSgNtZool
Kamm	SbSgMs
Kammchen:	SbSgNtDimt	Kamm	SbSgMs
Kammer	SbSgFm
Kamp	xx
Kampe:	SbSgMsPers
Kampf	SbSgMs
Kampfer	SbSgMs
Kampfer:	SbSgMsPers
Kandel	SbSgMs	kandeln	VbIn
Kanker	xx
Kannchen:	SbSgNtDimt	Kanne	SbSgFm
Kanne	SbSgFm
Kannel:	xx
Kant	NmSurn
Kante	SbSgFm
Kantel	xx
Kanter	NmSurn
Kanzel	SbSgFm
Kanzler	SbSgMsProf	Kanzel	SbSgFm
Kap	SbSgNtGeog
Kaper	xx
Kappchen:	SbSgNtDimt	Kappe	SbSgFm
Kappe	SbSgFm
Kapsel	SbSgFm	kapseln	VbIn
Kapten:	xx
Kar	xx
Karde	xx
Karen	NmFmPren
Karer	xx
Karl	NmMsPren
Karmel	SbSgMsGeogMont
Karmen	NmFmPren
Karn	xx
Karner	xx
Karnten:	NmGeogRegnForg.At
Karntner:	SbSgMsPersGeogRegnForg.At
Karpfen	SbSgMsZool
Karrchen:	SbSgNtDimt	Karre	SbSgFm
Karre	SbSgFm
Karrner:	xx
Karst	SbSgMs
Karsten	NmMsPren
Kart	xx
Kartchen:	SbSgNtDimt	Karte	SbSgFm
Karte	SbSgFm
Karzer	SbSgMs
Kasch	xx
Kaschen:	xx
Kascher:	SbSgMs
Kase:	SbSgMsNutr
Kasel	xx
Kaser	xx
Kaser:	SbSgMsProf
Kasper	SbSgMsPers
Kasse	SbSgFm
Kassel	NmGeogCity.De
Kassler	SbSgNt	Kassel	NmGeogCity.De
Kastchen:	SbSgNtDimt	Kasten	SbSgMs
Kaste	SbSgFm
Kasten	SbSgMs
Kastner:	xx
Kat	xx
Katchen:	NmNtDimt	Kate:	NmFmPren
Kate	SbSgFm
Kate:	NmFmPren
Katen	SbPl	Kate	SbSgFm
Kater	SbSgMsZool
Kathchen:	NmFmPrenDimt	Kathe:	NmFmPren
Kathe:	NmFmPren
Katner:	xx
Katzchen:	SbSgNtDimtZool	Katze	SbSgFmZool
Katze	SbSgFmZool
Kaub	xx
Kaue	xx
Kauf	SbSgMs
Kaufer:	SbSgMsPers
Kaulchen:	SbSgNtDimt	Kaule:	SbSgFm
Kaule	xx
Kaule:	SbSgFm
Kausch	xx
Kausche	xx
Kautel	xx
Kauter	xx
Kauz	SbSgMs
Kauzchen:	SbSgNtDimtZool
Kebse	xx
Keder	xx
Keep	xx
Keeper	SbSgMsForg.En	
Kees	xx
Kefe	xx
Kegel	SbSgMs	kegeln	VbIn
Kegler	SbSgMs
Kehl	NmGeogCity.De
Kehlchen	SbSgNtDimt	Kehle	SbSgFmBody
Kehle	SbSgFmBody
Kehr	SbSg
Kehre	SbSgFm
Keib	SbSgMsDial
Keil	SbSgMs
Keile	SbSgFm
Keiler	SbSgMsZool
Keim	SbSgMs
Keks	SbSgMsNutr
Kelch	SbSgMs
Kelle	SbSgFm
Keller	SbSgMs
Kellner	SbSgMsProf
Kelt	xx
Kelte	SbSgMsPers
Kelter	SbSgFm
Kennel	xx
Kenner	SbSgMs	kennen	VbIn
Kent	NmGeogCityForg.En
Kepler	NmSurn
Kerb	xx
Kerbe	SbSgFm
Kerbel	SbSgMsNutr
Keren	xx
Kerf	xx
Kerker	xx
Kerl	SbSgMsPers
Kerlchen	SbSgNtDimtPers	Kerl	SbSgMsPers
Kern	SbSgMs
Kerner	SbSgMsNutr
Kerwe	xx
Kerze	SbSgFm
Kescher	xx		
Kessel	SbSgMs
Ketsch	xx
Kettchen	SbSgNtDimt	Kette	SbSgFm
Kette	SbSgFm
Kettel	SbSgMs
Ketzer	SbSgMsPers
Keule	SbSgFm
Keuper	xx
Keusche	xx
Keuschler	xx
Kfor	AbSgFm
Khan	NmSurnForg
Kick	SbSgMs
Kicker	SbSgMs	kicken	VbIn
Kid	SbSgNt
Kids	SbPlForg.En	Kid	SbSgNt
Kiefer	SbSgFmBota
Kiefer	SbSgMsBody
Kieke	xx
Kieker	SbSgMs	kieken	VbIn
Kiel	NmGeogCity.De
Kieler	SbSgMs	Kiel	NmGeogCity.De
Kieme	SbSgFm
Kien	xx
Kiepe	SbSgFm
Kies	SbSgMs
Kiesel	SbSgMs	kieseln	VbIn
Kiewer	SbSgMsGeogCityForg.Uk	Kiew	NmGeogCityForg.Uk
Kiew	NmGeogCityForg.Uk
Kiez	SbSgMs
Kiffer	SbSgMs	kiffen	VbIn
Killer	SbSgMsForg	killen	VbIn
Kiln	xx
Kilt	SbSgMsForg.En
Kimber	xx
Kimm	xx
Kimme	SbSgFm
Kind	SbSgNtPers
Kindchen	SbSgNtDimtPers	Kind	SbSgNtPers
King	SbSgMsForg.En
Kink	xx
Kinn	SbSgNtBody
Kipf	xx
Kipfel	SbSgMsNutr
Kipfler	xx
Kippe	SbSgFm	kippen	VbIn
Kipper	SbSgMs	kippen	VbIn
Kips	xx
Kir	SbSgMsNutrForg
Kirbe	xx
Kirche	SbSgFm
Kirchner	NmSurn
Kirke	xx
Kirsch	SbSgMsNutr	Kirsche	SbSgFmNutr
Kirsche	SbSgFmNutr
Kirsten	NmFmPren
Kissen	SbSgNt
Kiste	SbSgFm
Kitsch	SbSgMs
Kitt	SbSgMs
Kittchen	SbSgNtDimt
Kittel	SbSgMs
Kitz	SbSgNt
Kitzchen	SbSgNtDimt	Kitz	SbSgNt
Kitze	xx
Kitzel	SbSgMs	kitzeln	VbIn
Kitzler	SbSgMs
Klacks	SbSgMs
Kladde	SbSgFm
Klaffer:	SbSgMsZool
Klafter	SbSgMs
Klage	SbSgFm
Klager:	SbSgFmPers	klagen	VbIn
Klamm	SbSgFm
Klammer	SbSgFm
Klampe	xx
Klampfe	SbSgFm
Klan	SbSgMsForg
Klang	SbSgMs	klingen	VbInStrg
Klapf	xx
Klappe	SbSgFm
Klapper	SbSgMs	klappen	VbIn
Klaps	SbSgMs
Klapschen:	SbSgNtDimt	Klaps	SbSgMs
Klarchen:	NmPrenNtDimt	Klare:	NmFmPren
Klare	xx
Klare:	NmFmPren
Klas	xx
Klater	xx
Klatsch	SbSgMs
Klatsche	SbSgFm
Klatscher	SbSgMs	klatschen	VbIn
Klau	SbSgMs
Klauber	xx
Klaue	SbSgFm
Klaus	NmMsPren
Klause	SbSgFm
Klausel	SbSgFm
Klausner	xx
Klebe	xx
Kleber	SbSgMs	kleben	VbIn
Klecks	SbSgMs
Kleckser	SbSgMs	klecksen	VbIn
Klee	SbSgMsBota
Klei	xx
Kleiber	SbSgMsZool
Kleid	SbSgNt
Kleidchen	SbSgNtDimt	Kleid	SbSgNt
Kleie	SbSgFm
Kleinchen	SbSgNtDimtPers	Kleine	SbSgFmPers
Kleine	SbSgFmPers
Kleist	NmSurn
Kleister	SbSgMs
Klemme	SbSgFm
Klemmer	xx
Klempner	xx
Klepper	xx
Klette	SbSgFmBota
Kletze	xx
Kleve	NmGeogCity.De
Klever	SbSgMsPersNmGeogCity.De
Klevner	xx
Klezmer	xx
Klick	SbSgMs
Klicker	xx
Klient	SbSgMs
Klientel	SbSgMsForg
Kliesche	xx
Kliff	SbSgNt
Klimme	xx
Klimt	NmSurn
Klinge	xx
Klingel	SbSgFm	klingeln	VbIn
Klinke	SbSgFm	klinken	VbIn
Klinker	SbSgMs	klinken	VbIn
Klinse	xx
Klinze	xx
Klippe	SbSgFm
Klipper	SbSgMsProf
Klips	xx
Klitsche	SbSgFm
Klo	SbSgNt
Kloben	SbSgMs
Kloben:	xx
Klon	SbSgMsForg
Klopfel:	xx
Klopfer	SbSgMs	klopfen	VbIn
Kloppe	xx
Kloppel:	SbSgFm
Klops	SbSgMsNutr
Kloster	SbSgNt
Kloten:	xx
Klotz	SbSgMs
Klotzchen:	SbSgNtDimt	Klotz	SbSgMs
Kloß	SbSgMsNutr
Kloßchen:	SbSgNtDimtNutr	Kloß	SbSgMsNutr
Klub	SbSgMs
Kluft	SbSgFm
Klugler:	xx
Klump	SbSgMs
Klumpchen:	SbSgNtDimt	Klump	SbSgMs
Klungel:	SbSgMs
Klunker	SbSgNt
Klunse	xx
Kluntje	xx
Kluppe	SbSgFm
Klus	xx
Kluse	xx
Kluse:	xxDiar
Kluten:	xx
Kluver:	xx
Knabe	SbSgMsPers
Knack	xx
Knacke:	xx
Knacker	SbSgMs	knacken	VbIn
Knacks	SbSgMs	knacken	VbIn
Knagge	xx
Knaggen	xx
Knall	SbSgMs
Knappe	SbSgMsPers
Knarre	SbSgFm
Knast	SbSgMs
Knaster	SbSgMs
Knastrer	xx
Knatsch	SbSgMs
Knauel:	SbSgNt
Knauf	SbSgMs
Knaufchen:	SbSgNtDimt	Knauf	SbSgMs
Knaul	xx
Knaulchen:	SbSgNtDimt	Knauel:	SbSgNt
Knauser	SbSgMsPers
Knebel	SbSgMs	knebeln	VbIn
Knecht	SbSgMsProf
Kneif	xx
Kneifer	SbSgMs	kneifen	VbIn
Kneip	xx
Kneipe	SbSgFm
Kneipp	NmSurn
Knete	SbSgFmVulg
Knick	SbSgMs
Knicker	SbSgMsPers
Knicks	SbSgMs	knicken	VbIn
Knie	SbSgNtBody
Knies	SbSgMs
Kniff	SbSgMs	kneifen	VbInStrg
Knigge	NmSurn
Knilch	SbSgMsPersVulg
Knips	SbSgMs
Knipser	SbSgMs	Knips	SbSgMs
Knirps	SbSgMsPers
Knittel	SbSgMs
Knitter	xx
Knobel	SbSgMs	knobeln	VbIn
Knochel:	SbSgMsBody
Knochen	SbSgMsBody
Knodel:	SbSgMsNutr
Knofel	SbSgMsVulg
Knollchen:	SbSgNtDimt	Knolle	SbSgFm
Knolle	SbSgFm
Knollen	SbPl	Knolle	SbSgFm
Knopf	SbSgMs
Knopfchen:	SbSgNtDimt	Knopf	SbSgMs
Knopper	xx
Knorpel	SbSgMs
Knorren	xx
Knorz	SbSgMs
Knorzer	xx
Knospchen:	SbSgNtDimt	Knospe	SbSgFm
Knospe	SbSgFm
Knotchen:	SbSgNtDimt	Knoten	SbSgMs
Knoten	SbSgMs
Knubbe	xx
Knubbel	SbSgMs	knubbeln	VbIn
Knubben	xx
Knuff	SbSgMs
Knulch:	xx
Knuller:	SbSgMs
Knuppel:	SbSgMs
Knust	xx
Knut	NmMsPren
Knute	SbSgFm
Knuttel:	SbSgMs
Kobel	xx
Koben	SbSgMs
Kober	xx
Koch	SbSgMsProf
Kocher	SbSgMs	kochen	VbIn
Kocher:	SbSgMsDiar
Kode	SbSgMs
Koder:	SbSgMs
Kofel	xx
Kofen	xx
Koffer	SbSgNt
Kog	xx
Kogel	xx
Kogge	SbSgFm
Kohl	SbSgMsNutr
Kohle	SbSgFmMinr
Kohler:	SbSgMsProf
Koje	SbSgFm
Koker	SbSgMs	koken	VbIn
Kokke	xx
Koks	SbSgMs
Kokser	SbSgMs	koksen	VbIn
Kolben	SbSgMs
Kolk	xx
Koller	SbSgMs
Kolm	xx
Koln:	NmGeogCity.De
Kolner:	SbSgMsPersGeogCity.De
Kolsch:	SbSgNtNutr
Kolter	xx
Kom:	xx
Konche	xx
Konen	xx
Konner:	SbSgMsPers	konnen:	VbIn
Konten	SgPl	Konto	SbSgNtForg
Konter	SbSgNtForg
Koper:	SbSgMsClth
Kopf	SbSgMsBody
Kopfchen:	SbSgNtDimtBody	Kopf	SbSgMsBody
Kopfler:	xx
Koppe	xx
Koppel	SbSgFm	koppeln	VbIn
Kopper:	xx
Kops	xx
Kopte	SbSgMsPers
Korb	SbSgMs
Korbchen:	SbSgNtDimt	Korb	SbSgMs
Korber	xx
Kord	SbSgMsClth
Korde	xx
Kordel	SbSgFm
Kore	xx
Kork	SbSgMsBota
Korn	SbSgMsNutr
Korn	SbSgNtBota
Kornchen:	SbSgNtDimtNutr	Korn	SbSgNtBota
Korner	xx
Korner:	SbPl	Korn	SbSgNtBota
Korper:	SbSgMsBody
Korps	SbSgNtForg
Korse	SbSgMsPersGeogRegnForg.Fr	Korsika	NmGeogRegnForg.Fr
Korste	xx
Kos	xx
Kost	xx
Kot	SbSgMs
Kote	xx
Kote:	xxDiar
Kotel:	xx
Koter:	SbSgMsZool
Kothen:	xx
Kotner:	xx
Kotten	xx
Kotter	xx
Kotter:	xxDiar
Kotze	SbSgFm	kotzen	VbIn
Kotze:	xx
Kotzer:	xx
Kraal	SbSgMsForg
Krabbe	xx
Krach	SbSgMs
Kracher	SbSgMs	krachen	VbIn
Krachzer:	xx
Kracke	xx
Kracker:	SbSgMsNutr
Krad	SbSgNtAbbr	Kraftrad	SbSgNt
Krage	xx
Kragen	SbSgMs
Krahe:	SbSgFmZool
Krahl:	xx
Krain	xx
Krake	SbSgMsZool
Krakel	SbSgMs
Kral	xx
Kralle	SbSgFm
Kram	SbSgMs
Kramer:	SbSgMsProf
Krampe	xx
Krampf	SbSgMs
Kran	SbSgMs
Kranchen:	SbSgNtDimt	Kran	SbSgMs
Krangel	xx
Kranke	xx
Kranz	SbSgMs
Kranzchen:	SbSgNtDimt	Kranz	SbSgMs
Krapfchen:	SbSgNtDimt	Krapfen	SbSgMs
Krapfel:	xx
Krapfen	SbSgMs
Krapp	xx
Krappel:	xx
Krater	SbSgMs
Kratt	xx
Kratten	xx
Kratz	xx
Kratzchen:	xx
Kratze	xx
Kratze:	SbSgFm
Kratzer	SbSgMs
Kratzer:	xx
Krauel:	xx
Kraul	xx
Krauler	SbSgMs	kraulen	VbIn
Krause	SbSgFm
Krauss	xx
Kraut	SbSgNtBota
Krautchen:	SbSgNtDimtBota	Kraut	SbSgNtBota
Krauter	SbSgMs	krauten	VbIn
Krauter:	SbPl	Kraut	SbSgMs
Kraxe	SbSgFm
Kraxler	SbSgMs
Kraze:	xx
Krebs	SbSgMsMedc
Krebs	SbSgMsZool
Krehl	xx
Kreide	SbSgFm
Kreis	SbSgMs
Kreisel	SbSgMs	kreiseln	VbIn
Kreiser	xx
Krem	xx
Kreme	xx
Kreml	NmMsGeogForg.Ru
Krempe	SbSgFm
Krempel	SbSgMs	krempeln	VbIn
Kremser	xx
Krengel	xx
Krepp	SbSgMs
Kresse	SbSgFmNutr
Kreta	NmGeogRegnForg.Gr
Krete	xx
Kreter	SbSgMsGeogRegnForg.Gr	Kreta	NmGeogRegnForg.Gr
Kretschmer	NmSurn
Kreuz	SbSgNt
Kreuzer	SbSgMsMilt	kreuzen	VbIn
Kribbe	xx
Krickel	xx
Krieche	xx
Kriecher	SbSgMs	kriechen	VbIn
Krieg	SbSgMsMilt
Krieger	SbSgMsMilt	kriegen	VbIn
Krill	xx
Krim	NmFmGeogRegnForg.Ru
Krimmer	xx
Kringel	SbSgMs	kringeln	VbIn
Krippe	SbSgFm
Kris	NmFmPren
Krise	SbSgFm
Krolle	xx
Kronchen:	SbSgNtDimt	Krone	SbSgFm
Krone	SbSgFm
Kropel:	xx
Kropf	SbSgMsBody
Kropfchen:	SbSgNtBodyDimt	Kropf	SbSgMsBody
Kropfer:	xx
Krose:	xx
Krot	xx
Krote:	SbSgFmZool
Kroten:	SbPlZool	Krote:	SbSgFmZool
Krov:	xx
Krover:	xx
Krucke	xx
Krucke:	SbSgFm
Krug	SbSgMs
Krugel:	xx
Kruger:	NmSurn
Kruke	xx
Krumchen:	SbSgNtNutrDimt	Krume	SbSgFmNutr
Krume	SbSgFmNutr
Krumel:	SbSgMsNutr
Krumme	xx
Krummer:	SbSgMs	krumm	Aj
Krumper:	xx
Krupp	SbSgMsMedc
Kruppe	SbSgFm
Kruppel:	SbSgMsPers
Krustchen:	SbSgNtDimt	Kruste	SbSgFm
Kruste	SbSgFm
Krux	SbSgMsForg.Lt
Kubel:	SbSgMs
Kuben	xx
Kuche:	SbSgFm
Kuchen	SbSgMsNutr
Kucken:	xx
Kuder	xx
Kues	NmSurn
Kufe	SbSgFm
Kufer:	SbSgMsProf
Kuff	xx
Kugel	SbSgFm	kugeln	VbIn
Kuh	SbSgFmZool
Kuhle	SbSgFm
Kuhle:	SbSgFmDiar	kuhl:	AjPrim
Kuhler:	SbSgMs	kuhl:	AjPrim
Kuhlte:	xx
Kuken:	SbSgNtZool
Kuller	xx
Kulm	xx
Kult	SbSgMs
Kumm	xx
Kumme	xx
Kummel:	SbSgMsNutr
Kummer	SbSgMs
Kump	xx
Kumpel	SbSgMsPersVulg
Kumpen	xx
Kumpf	xx
Kumst	xx
Kumt	xx
Kunde	SbSgFm	kunden:	VbIn
Kunder:	xx
Kunkel	xx
Kunst	SbSgFm
Kunstler:	SbSgMsProf
Kunz	NmSurn
Kupe:	xx
Kuper:	xx
Kupfer	SbSgNtMetl
Kuppe	SbSgFm
Kuppel	SbSgFm	kuppeln	VbIn
Kuppler	SbSgMsPers
Kur:	SbSgFm
Kurbel	SbSgFm	kurbeln	VbIn
Kurde	SgSbMsPersGeogRegnForg
Kurre	xx
Kurs	SbSgMs
Kursch:	xx
Kurschner:	SbSgMsProf
Kurse	SbPl	Kurs	SbSgMs
Kurste:	xx
Kurt	NmMsPren
Kurve	SbSgFm
Kurze	SbSgFmPers
Kurze:	SbSgFm	kurz	AjPrim
Kurzel:	SbSgNt	kurz	AjPrim
Kuschel	SbSgMs	kuscheln	VbIn
Kusel	xx
Kuss	SbSgMs
Kusschen:	SbSgNtDimt	Kuss	SbSgMs
Kussel	xx
Kuste:	SbSgFm
Kuster:	SbSgMsProf
Kute	xx
Kutsche	SbSgFm
Kutscher	SbSgMsProf	Kutsche	SbSgFm
Kutte	SbSgFm
Kuttel	xx
Kutter	SbSgMs
Kux	xx
Kwass	xx
Lab	SbSgNtNutr
Labe	SbSgFm
Label	SbSgNtForg
Lache	SbSgFm
Lacher	SbSgMs	lachen	VbIn
Lachs	SbSgMsZool
Lachte	xx
Lachter	xx
Lack	SbSgMs
Lacke	SbPl	Lack	SbSgMs
Lackel	SbSgMs
Ladchen:	SbSgNtDimt	Laden	SbSgMs
Lade	SbSgFm	laden	VbInStrg
Laden	SbSgMs
Lader	SbSgMs	laden	VbIn
Laffe	SbSgMsPers
Lage	SbSgFm
Lagel:	xx
Lager	SbSgNt
Lahme:	xx
Lahn	NmFmGeogFlum.De
Lahr	NmGeogCity.De
Laib	SbSgMsNutr
Laibchen	xx
Laich	SbSgMsZool
Laie	SbSgMsPers
Lake	SbSgFm
Laken	SbSgNt
Lamm	SbSgNtZool
Lammchen:	SbSgNtDimtZool	Lamm	SbSgNtZool
Lampchen:	SbSgNtDimt	Lampe	SbSgFm
Lampe	SbSgFm
Land	SbSgNt
Landchen:	SbSgNtDimt	Land	SbSgNt
Lande:	SbSgFm
Landle:	SbSgNtDial
Landler:	SbSgMs
Landser	SbSgMs
Lange:	SbSgFm	lang	Aj
Lanze	SbSgFm
Lapp	xx
Lappchen:	SbSgNtDimt	Lappen	SbSgMs
Lappe	SbSgMsPers
Lappen	SbSgMs
Lar	xx
Larche:	SbSgFmBota
Laren	xx
Larm:	SbSgMs
Lars	xx
Larve	SbSgFmZool
Lasche	SbSgFm
Lase	xx
Laser	SbSgMsForg
Laster	SbSgMs	lasten	VbIn
Lats	xx
Latsch	xx
Latsche	SbSgFmBota
Latte	SbSgFm
Latz	SbSgMs
Latzchen:	SbSgNtDimt	Latz	SbSgMs
Laub	SbSgNtBota
Laube	SbSgFm
Lauch	SbSgMsNutr
Lauer	SbSgFm
Lauf	SbSgMs
Laufel:	xx
Laufer:	SbSgMs
Lauge	SbSgFm
Laune	SbSgFm
Laus	SbSgFm
Lausche	xx
Lauschen:	SbPlNtDimt	Laus	SbSgFm
Lauscher	SbSgMs	lauschen	VbIn
Lauser	SbSgMs	lausen	VbIn
Laute	SbSgFmMusi
Laven	xx
Leber	SbSgFmMedc
Lech	NmMsGeogFlum.De
Lecke	xx
Leder	SbSgNt
Lee	SbSgNt
Leere	SbSgFm	leer	Aj
Lefze	SbSgFm
Legel	xx
Lehen	SbSgNt
Lehm	SbSgMs
Lehne	SbSgFm
Lehr	xx
Lehre	SbSgFm
Lehrer	SbSgMs	lehren	VbIn
Lei	xx
Leib	SbSgMs
Leibchen	SbSgNtDimt
Leich	xx
Leiche	SbSgFm
Leichte	xx
Leichter	SbSgMs
Leid	SbSgNt	leiden	VbInStrg
Leier	SbSgFm
Leif	xx
Leihe	SbSgFm	leihen	VbInStrg
Leik	xx
Leim	SbSgMs
Lein	SbSgMsNutr
Leine	SbSgFm
Leist	xx
Leiste	SbSgFm
Leite	xx
Leiter	SbSgFm	leiten	VbIn
Leiter	SbSgMs	leiten	VbIn
Lek	xx
Lende	SbSgFmBody
Lene	xx
Leng	xx
Lenker	SbSgMs	lenken	VbIn
Lenne	xx
Lerche	SbSgFmZool
Lerner	xx
Lesbe	SbSgFmPers
Lese	xx
Leser	SbSgMsPers	lesen	VbIn
Lethe	xx
Lette	SbSgMsPersGeogCtry.Lv	Lettland	NmGeogCtry.Lv
Letten	SbPlPersGeogCtry.Lv	Lette	SbSgMsPersGeogCtry.Lv
Letter	SbSgFm
Lettner	SbSgMs
Letzt	xx
Leu	SbSgMsZool	Lowe:	SbSgMsZool
Leuchte	SbSgFm	leuchten	VbIn
Leuchter	SbSgMs	leuchten	VbIn
Leugner	SbSgMsPers	leugnen	VbIn
Leutchen	SbSgNtDimtPers	Leute	SbPlPers
Leute	SbPlPers
Level	SbSgMsForg.En
Lever	xx
Lew	xx
Lex	SbSgNtForg.Lt
Li	xx
Licht	SbSgNt
Lichtchen	SbSgNtDimt	Licht	SbSgNt
Lichte	SbSgFm
Lichter	SbPlNt	Licht	SbSgNt
Lid	SbSgNtBody
Liebchen	SbSgNtDimtPers	Liebe	SbSgFm
Liebden	xx
Liebe	SbSgFm
Liebste	SbSgFmPers
Lied	SbSgNtMusi
Liedchen	SbSgNtMusiDimt	Lied	SbSgNtMusi
Liege	SbSgFm
Lieger	xx
Liek	xx
Lien	xx
Lienz	xx
Liesch	xx
Lieschen	NmFmPrenDimt
Liese	NmFmPren
Liesel	NmFmPrenDimt
Liesen	xx
Liesl	NmFmPrenAbbrDial
Lift	SbSgMsForg.En
Lille	NmGeogCityForg.Fr
Lincke	NmSurn
Linde	SbSgFmBota
Line	SbSgFmForg.En
Linke	SbSgFm
Linkser	xx
Linse	SbSgFm
Linth	xx
Linz	NmGeogCityForg.At
Linzer	SbSgMsGeogCityForg.At	Linz	NmGeogCityForg.At
Lippe	SbSgFmBody
Lise	xx
Lismer	xx
Lispler	SbSgMs
Lisse	xx
List	SbSgFm
Liste	SbSgFm
Liszt	NmSurnMusi
Lit	xx
Liter	SbSgMsMeas
Litze	SbSgFm
Livre	xx
Lob	SbSgNt
Loch	SbSgNt
Locher	SbSgMs	lochen	VbIn
Lockchen:	SbSgNtDimtBody	Locke	SbSgFmBody
Locke	SbSgFmBody
Lodde	xx
Loddel	xx
Lode	xx
Loden	SbSgMsClth
Lodge	xx
Lodsch	xx
Lodz	NmGeogCityForg.Pl
Loffel:	SbSgMs
Loffler:	NmSurn
Loft	SbSgMsForg.En
Loge	SbSgFmForg
Logge	xx
Logger	SbSgMsForg	loggen	VbIn
Lohe	SbSgFm
Lohn	SbSgMs
Lok	SbSgFmAbbr	Lokomotive	SbSgFm
Lolch	xx
Lomber	xx
Longe	SbSgFmForg.Fr
Lons:	NmSurn
Lorchel	xx
Lord	SbSgMsTitlForg.En
Lore	NmFmPrenAbbr
Lork	xx
Lorke	xx
Loscher:	xx
Loser	xx
Loss:	SbSgMsMinr
Lost	SbSgNtChem
Lot	SbSgNt	loten	VbInStrg
Lotse	SbSgMsProf
Lottchen	NmFmPrenDimt	Lotte	NmFmPren
Lotte	NmFmPren
Lotter	SbSgMs
Lover	SbSgMsForg.En
Lowe:	SbSgMsZool
Loß:	SbSgMs
Lu	SbSg
Lubke:	NmSurn
Luch	xx
Luchs	SbSgMsZool
Lucht	xx
Lucke:	SbSgFm
Lude	xx
Luder	SbSgNtPers
Ludger	NmMsPren
Lues	SbGe	Lu	SbSg
Luft	SbSgFm
Luftchen:	SbSgNtDimtMeto	Luft	SbSgFm
Lufter:	SbSgMs
Lug	SbSgMs
Luge:	SbSgFm	Lug	SbSgMs
Lugner:	SbSgMs
Luk	xx
Luke	SbSgFm
Lulle	xx
Luller	xx
Lumen	SbSgNtMeas
Lumme	xx
Lummel	xx
Lummel:	SbSgMsPers
Lump	SbSgMsPers
Lunch	SbSgMsForg.En
Lund	xx
Lunge	SbSgFmBody
Lunker	SbSgMs
Lunse:	xx
Lunt:	xx
Lunte	SbSgFm
Lupe	SbSgFm
Lupf	xx
Luppe	xx
Lurch	SbSgMsZool
Lure	xx
Lusche	SbSgFm
Lust	SbSgFm
Luster	xx
Luster:	SbSgMs
Lustren	xx
Luther	NmSurn
Lutscher	SbSgMs	lutschen	VbIn
Lutte	xx
Lutter	xx
Lutz	NmMsPren
Luv	SbSgNt
Lux	SbSgNtMeas
Ma	xx
Maar	xx
Maas	NmGeogFlumForg.Be
Maat	SbSgMsProf
Mac	SbSgMsTitlForg.En
Mach	SbSgNtMeas
Mache	SbSgFm
Macher	SbSgMs	machen	VbIn
Macht	SbSgFm
Macke	SbSgFm
Macker	SbSgMsPers	Macke	SbSgFm
Madchen:	SbSgNtDimtZool	Made	SbSgFmZool
Made	SbSgFmZool
Madel:	SbSgNtDimt
Magd	SbSgFmProf
Magen	SbSgMsBody
Mahd	SbSgFm
Mahder:	xx
Maher:	SbSgMs
Mahl	SbSgNt
Mahler	NmSurn
Mahne:	SbSgFm
Mahner	SbSgMs	mahnen	VbIn
Mahr	xx
Mahr:	SbSgFm
Mahre:	SbSgFmZool
Mahren:	SbPlAc
Mahrer:	xx
Mai	SbSgMsTime
Maid	SbSgFm
Maie	xx
Maike	NmFmPren
Mail	SbSgFmForg.En
Main	NmGeogFlum
Maine	NmGeogRegnForg
Mainz	NmGeogCity.De
Mainzer	SbSgMsGeogCity.De	Mainz	NmGeogCity.De
Maire	xx
Mais	SbSgMsNutr
Maisch	SbSgFm
Maische	SbSgFm
Maiß	xx
Makel	SbSgMs	makeln	VbIn
Makler	SbSgMsProf
Makler:	xx
Malchen	xx
Mal		SbSgNtFreq
Maler	SbSgMs	malen	VbIn
Malm	xx
Malte	NmMsPren
Malter	xx
Malve	SbSgFmBota
Malz	SbSgNtNutr
Malzel:	xx
Malzer:	SbSgMsProf
Mandel	SbSgFmNutr
Mandl	xx
Manen	xx
Mange	NmSurn
Mangel	SbSgMs	mangeln	VbIn
Mann	SbSgMsPers
Mannchen:	SbSgNtDimtPers	Mann	SbSgMsPers
Manne:	SbSgMsVulg	Mann	SbSgMsPers
Mans	xx
Mansch	xx
Mantel	SbSgMs
Mappchen:	SbSgNtDimt	Mappe	SbSgFm
Mappe	SbSgFm
Mar:	SbSgFm
Marbel	xx
Marbel:	xxDiar
Marc	NmMsPrenForg
Marcel	NmMsPrenForg
March	NmGeogCity.De
Marchen:	SbSgNt
Marder	SbSgMsZool
Mare:	xx
Maren	NmFmPren
Marge	SbSgFmForg.Fr
Mark	SbSgNtNutr
Marke	SbSgFm
Marke:	xx
Marker	SbSgMsForg
Marker:	xx
Markt	SbSgMs
Marmel	xx
Marne	NmGeogFlumForg.Fr
Mars	NmAstr
Marsch	SbSgMs
Marte:	xx
Marter	SbSgFm
Marx	NmSurn
Marz:	SbSgMsTime
Masche	SbSgFm
Masel	xx
Maser	SbSgFm
Maske	SbSgFm
Massel	SbSgMsJidd
Mast	SbSgMs
Master	SbSgMsForg.En
Master:	SbSgMsProf
Match	SbSgNtForg.En
Mate	SbSgMsNutr
Mater	SbSgFm
Mathe	SbSgFmAbbr	Mathematik	SbSgFm
Matte	SbSgFm
Matz	xx
Matzchen:	SbSgNtDimt
Matze	SbSgFm
Matzen	SbPl	Matze	SbSgFm
Maud	xx
Mauer	SbSgFm
Mauke	xx
Maul	SbSgNtBody
Maulchen:	SbSgNtDimtBody	Maul	SbSgNtBody
Maure	SbSgMsPers
Maurer	SbSgMsProf
Maus	SbSgFmZool
Mauschen:	SbSgNtDimtZool	Maus	SbSgFmZool
Mauser	SbSgFm
Maut	SbSgFm
Mautner	xx
Max	NmMsPren
Maxchen:	NmNtDimt	Max	NmMsPren
Mazen:	SbSgMsPers
Maß	SbSgNt
Maßchen:	xx
Maße	SbPl	Maß	SbSgNt
Meder	xx
Meer	SbSgNt
Mehl	SbSgNtNutr
Mehrer	SbSgMs	mehren	VbIn
Meien	xx
Meier	NmSurn
Meike	NmFmPren
Meile	SbSgFmMeas
Meiler	SbSgMs
Meise	SbSgFmZool
Meisje	xx
Meister	SbSgMsProf
Meißel	SbSgMs	meißeln	VbIn
Meißen	NmGeogCity.De
Meißner	xx
Melber	xx
Melchter	xx
Melde	xx
Melder	SbSgMs	melden	VbIn
Melker	SbSgMs	melken	VbIn
Memel	NmFmGeogFlum
Memme	SbSgFm
Mendel	NmSurn
Menge	SbSgFm
Mengsel	xx
Mensch	SbSgMsPers
Menzel	NmSurn
Mergel	SbSgMs	mergeln	VbIn
Merger	SbSgMsForg.En
Merk	NmSurn
Merker	SbSgMs	merken	VbIn
Merle	SbSgFm
Merten	NmSurn
Mesche	xx
Mesh	xx
Mesmer	xx
Mesner	xx
Messe	SbSgFm
Messer	SbSgMs	messen	VbIn
Messmer	NmSurn
Messner	SbSgMsProf
Meste	xx
Met	SbSgMsNutr
Meter	SbSgMsMeas
Metren	xx
Mett	SbSgNtNutr
Mette	SbSgFm
Metz	NmGeogCityForg.Fr
Metze	SbSgFm
Metzen	SbPl	Metze	SbSgFm
Metzg	xx
Metzge	xx
Metzger	SbSgMsProf
Metzler	NmSurn
Meuchler	SbSgMsPers
Meute	SbSgFm
Michel	NmMsPrenDimt
Midder	xx
Mieder	SbSgNt
Mief	SbSgFm
Mieke	xx
Miene	SbSgFm
Miere	xx
Mieschen	xx
Miese	SbSgFm	mies	Aj
Miete	SbSgFm
Mieter	SbSgMsPers	mieten	VbIn
Miez	xx
Miezchen	SbSgNtDimtZool	Mieze	SbSgFmZool
Mieze	SbSgFmZool
Mike	NmMsPrenForg.En
Mikwe	xx
Milbe	SbSgFmZool
Milch	SbSgFmNutr
Milcher	xx
Milchner	xx
Milke	xx
Milken	xx
Mille	NuForg1000
Milz	SbSgFmBody
Mime	SbSgMsPers
Minchen	xx
Minden	NmGeogCity.De
Mine	SbSgFm
Mink	xx
Minne	SbSgFm
Minsk	NmGeogCityForg.Uk
Minstrel	xx
Minze	SbSgFmBota
Mischer	SbSgMs	mischen	VbIn
Mise	xx
Misel	xx
Mispel	xx
Miss	SbSgFmPersForg.En
Mist	SbSgMs
Mistel	SbSgFmBota
Mister	SbSgMs	misten	VbIn
Mitte	SbSgFm
Mittler	SbSgMs
Mix	SbSgMsForg.En
Mixer	SbSgMsForg	mixen	VbIn
Mneme	xx
Mo	xx
Mob	SbSgMsForg.En
Mobel:	SbSgNt
Mobster	xx
Mocke	xx
Mocken	xx
Modder	xx
Mode	SbSgFm
Model	SbSgMs	modeln	VbIn
Moder	SbSgMs
Moers	NmGeogCity.De
Mogler	SbSgMs
Mohn	SbSgMsBota
Mohr	SbSgMsPers
Mohre:	SbSgFmNutr
Mol	SbSgNtMeas
Molch	SbSgMsZool
Mole	SbSgFm
Molke	SbSgFm
Molken	SbPl	Molke	SbSgFm
Moll	SbSgNtMusi
Molle	SbSgFm
Moller:	NmSurn
Moltke	NmSurn
Mommsen	NmSurn
Monch:	SbSgMs
Mond	SbSgMs
Monster	SbSgNt
Mop	SbSgMs
Mopp	xx
Moppel	xx
Mops	SbSgMsZool
Mopschen:	SbSgNtDimtZool	Mops	SbSgMsZool
Mopse:	SbPl	Mops	SbSgMs
Morchel	SbSgFmBota
Mord	SbSgMs
Morder:	SbSgMsPers
Moren	xx
Morphe	xx
Morser:	SbSgMs
Mortel:	SbSgMs
Mosch	xx
Mose	xx
Mose:	SbSgFmBody
Mosel	NmFmGeogFlum
Moser:	xx
Most	SbSgMsNutr
Motel	SbSgNtForg
Motte	SbSgFmZool
Mowe:	SbSgFmZool
Muck	xx
Mucke	xx
Mucke:	SbSgFmZool
Mucker	xx
Mucks	SbSgMs
Muckser	SbSgMs	mucksen	VbIn
Mud	xx
Muff	SbSgMs
Muffe	SbSgFmBody
Muffel	SbSgMs	muffeln	VbIn
Mugel	xx
Mugge	xx
Muggel	xx
Muhe:	SbSgFm
Muhle:	SbSgFm	mahlen	VbInStrg
Muhme	SbSgFmPers
Mukden	xx
Mulch	SbSgMs
Mulde	SbSgFm
Mull	SbSgMs
Mull:	SbSgMsDiar
Muller:	NmSurn
Mulm	xx
Mum	xx
Mumm	SbSgMs
Mumme	xx
Mummel	xx
Mumps	SbSgMsMedc
Munch	xx
Munchen:	NmGeogCity.De
Munchner:	xx
Mund	SbSgMsBody
Mundchen:	SbSgNtDimtBody	Mund	SbSgMsBody
Mundel:	SbSgNtPers
Munster:	NmGeogCity.De
Munt	xx
Muntzer:	xx
Munze:	SbSgFm
Munzer:	xx
Mur	xx
Mure	SbSgFm
Murkel	xx
Murks	SbSgMsVulg
Murkser	SbSgMs	murksen	VbIn
Murmel	SbSgFm	murmeln	VbIn
Murner	xx
Murr	xx
Murten	xx
Murz:	xx
Mus	SbSgNtNutr
Musche	xx
Muschel	SbSgFmZool
Muse	SbSgFm
Muskel	SbSgMs
Muss	SbSgNt	mussen:	VbInStrg
Muster	SbSgNt
Mut	SbSgMs
Mutchen:	SbSgNtDimt	Mut	SbSgMs
Muter	xx
Muttchen	SbSgNtPersDimt
Mutter	SbSgFmPers
Mutz	SbSgMs
Mutzchen:	SbSgNtDimt	Mutz	SbSgMs
Mutze:	SbSgFm
Muße	SbSgFm
Mühle	SbSgFm
Naab	NmGeogFlum.De
Nabe	SbSgFm
Nabel	SbSgMs
Nachen	SbSgMs
Nachste:	xx
Nacht	SbSgFm
Nacken	SbSgMs
Nadel	SbSgFm	nadeln	VbIn
Nadler	NmSurn
Nagel	SbSgMs	nageln	VbIn
Nager	SbSgMs	nagen	VbIn
Nahe:	SbSgFm
Naht	SbSgFm
Naim	xx
Nain	xx
Naive	xx
Name	SbSgMs
Namen	SbPl	Name	SbSgMs
Nansen	NmSurn
Napf	SbSgMs
Napfchen:	SbSgNtDimt	Napf	SbSgMs
Narbe	SbSgFmBody
Narde	xx
Narr	SbSgMsPers
Naschen:	SbSgNtDimtBody	Nase	SbSgFmBody
Nascher	SbSgMs	naschen	VbIn
Nascher:	xx
Nase	SbSgFmBody
Nasse:	SbSgFm	nass	Aj
Natel	xx
Natter	SbSgFmZool
Naue	xx
Nauen	NmGeogCity.De
Navel	xx
Nebel	SbSgMsMeto	nebeln	VbIn
Neck	xx
Neer	xx
Neffe	SbSgMsPers
Neger	SbSgMsPers
Nehmer	xx
Neid	SbSgMs
Neider	SbSgMs	neiden	VbIn
Neige	SbSgFm
Neiße	NmFmGeogFlum
Nelke	SbSgFmBota
Nell	xx
Nenner	SbSgMs	nennen	VbIn
Nenze	xx
Neper	xx
Nepp	SbSgMs
Nepper	SbSgMs	neppen	VbIn
Nerd	SbSgMsForg.Us
Nerv	SbSgMsBody
Nerz	SbSgMsZool
Nessel	SbSgMs
Nest	SbSgNt
Nestchen	SbSgNtDimt	Nest	SbSgNt
Nestel	SbSgMs	nesteln	VbIn
Netz	SbSgNt
Neue	xx
Neume	xx
Neuner	SbSgMs
Neuss	NmGeogCity.De
Neusser	SbSgMsGeogCity.De	Neuss	NmGeogCity.De
Neutren	xx
News	SbSgFmForg.En
Ni	xx
Nibbler	xx
Nichte	SbSgFmPers
Nickel	SbSgNtMetl
Nicker	SbSgMs	nicken	VbIn
Nidel	xx
Nidle	xx
Niels	NmMsPren
Niere	SbSgFmBody
Nierndl	xx
Niet	SbSgMs
Niete	SbSgFm
Nieter	xx
Nietzsche	NmSurn
Nife	xx
Nigel	xx
Niger	NmGeogCtry.Ni
Nigger	SbSgMsPersVulg
Nigrer	SbSgMsPersGeogCtry.Ni
Nike	NmSurnForg.Us
Nil		NmGeogFlumForg.Eg
Nils	NmMsPren
Nipf	xx
Nippel	SbSgMs
Nische	SbSgFm
Nischel	xx
Nisse	xx
Nixchen	SbSgNtDimtPers	Nixe	SbSgFmPers
Nixe	SbSgFmPers
Njemen	xx
No	RpForg.En
Nock	xx
Nock:	xxDiar
Nocke	SbSgFm
Nocken	SbPl	Nocke	SbSgFm
Nolde	NmSurn
Nomen	SbSgNtForg.Lt	Name	SbSgMs
Non	RpForg.Lt	nein	Rp
None	SbSgFm
Nonen	SbPl	None	SbSgFm
Nonne	SbSgFmProf
Noppe	SbSgFm
Norchen:	xx
Nord	SbSgMs
Norden	SbSgMs	Nord	SbSgMs
Norgler:	SbSgMsPers
Norm	SbSgFm
Norne	SbSgFmPers
Not	SbSgFm
Note	SbSgFm
Noten	SbPl	Note	SbSgFm
Notker	xx
Noxe	xx
Noßel:	xx
Nucke	xx
Nucke:	xxDiar
Nuckel	SbSgMs	nuckeln	VbIn
Nuddel	xx
Nudel	SbSgFmNutr	nudeln	VbIn
Nulpe	SbSgFm
Nummer	SbSgFm
Nurse	SbSgFmProfForg.En
Nuss	SbSgFmNutr
Nusschen:	SbSgNtDimtNutr	Nuss	SbSgFmNutr
Nuster:	SbSgFm
Nut	SbSgFm
Nute	SbSgFm
Nuthe	xx
Nutsche	xx
Nutte	SbSgFmPers
Nutzer	SbSgMs	nutzen	VbIn
Obst	SbSgNtNutr
Obstler	SbSgMsNutr
Obstler:	xx
Ochs	SbSgMsZool
Ochschen:	SbSgNtDimtZool	Ochse	SbSgMsZool
Ochse	SbSgMsZool
Ochsle:	SbSgNtMeas
Od	xx
Odds	SbPlForg.En
Ode	SbSgFm
Odel	SbSgMsDial
Ofchen:	SbSgNtDimt	Ofen	SbSgMs
Ofen	SbSgMs
Offner:	SbSgMs
Oger	xx
Ohm	SbSgNtMeas
Ohm:	xx
Ohmd:	SbSgFm
Ohr	SbSgNtBody
Ohr:	xx
Ohrchen:	SbSgNtDimtBody	Ohr	SbSgNtBody
Oker	NmGeogFlum.De
Ol:	SbSgNt
Oler:	xx
Olle	SbSgFmVulg	Alte	SbSgFm
Olm	SbSgMsZool
Olten	NmGeogCityForg.Ch
Oltner	SbSgMsPersGeogCityForg.Ch
Omen	SbSgNtForg.Lt
Omsk	NmGeogCityForg.Ru
Onkel	SbSgMsPers
Oper	SbSgFmMusi
Opfer	SbSgNt
Orden	SbSgMs
Order	SbSgFmForg.En
Ordner	SbSgMs	ordnen	VbIn
Ordre	SbSgFmForg.Fr
Ore:	NmGeogForg.Se
Orfe	xx
Orff	NmSurnMusi
Orgel	SbSgFmMusi	orgeln	VbIn
Ort	SbSgMs
Ortchen:	SbSgNtDimt	Ort	SbSgMs
Orter	xx
Ortler	SbSgMs
Os	xx
Ose:	SbSgFm
Osel:	xx
Oser	xx
Osker	xx
Ost	SbSgMs
Ostler	SbSgMs
Otscher:	xx
Otter	SbSgMsZool
Owen	xx
Oxer	xx
Pa	xx
Paar	SbSgNtPers
Pace	xx
Pacht	SbSgFm
Pachter:	SbSgMsPers	Pacht	SbSgFm
Pack	SbSgNt
Packchen:	SbSgNtDimt
Packer	SbSgMs	packen	VbIn
Paddel	SbSgNt	paddeln	VbIn
Paddler	SbSgMsPers
Page	SbSgMsProf
Pager	SbSgMsForg.En
Pair	xx
Pak	SbSgFmAbbrMilt	Panzerabwehrkanone	SbSgFmMilt
Pakt	SbSgMs
Pale	xx
Palm	xx
Palme	SbSgFm
Palpe	xx
Pamp	SbSgMsVulg
Pampe	SbSgFmVulg
Pampf	xx
Pamps	xx
Pan	NmMsForg.Gr
Panel	SbSgNtForg
Panje	xx
Panne	SbSgFm
Panscher	SbSgMs	panschen	VbIn
Pansen	SbSgMs
Panter	xx
Panther	SbSgMsZool
Panzen	xx
Panzer	SbSgMsMilt
Papchen	xx
Paper	SbSgNtForg.En
Pappe	SbSgFm
Pappel	SbSgFmBota
Paps	xx
Papst	SbSgMsProf
Par	xx
Parchen:	SbSgNtDimtPers	Paar	SbSgNtPers
Pardel	xx
Parder	xx
Park	SbSgMs
Parker	SbSgMs	parken	VbIn
Parse	SbSgMsPers
Part	SbSgMs
Parte	xx
Parther	SbSgMsPers
Partner	SbSgMsPers
Parze	xx
Pas	xx
Pasch	SbSgMs
Pascher	xx
Paspel	SbSgNt
Pass	SbSgMs
Passe	SbSgFm
Passer	xx
Paste	SbSgFm
Patch	SbSgMsForg.En
Patchen	xx
Pate	SbSgFmPers
Patsche	SbSgFm
Patte	xx
Patzer	SbSgMs	patzen	VbIn
Pauke	SbSgFmMusi
Pauker	SbSgMs	pauken	VbIn
Paul	NmMsPren
Paunzen	xx
Pausche	xx
Pauschel:	xx
Pause	SbSgFm
Pax	SbSgMsForg.Lt
Pech	SbSgNt
Peene	xx
Peer	SbSgMsForg
Pegel	SbSgMs
Peiler	SbSgMs	peilen	VbIn
Pein	SbSgFm
Peitsche	SbSgFm
Pelle	SbSgFmVulg
Pelz	SbSgMs
Pence	SbPlCurrForg.En
Pendel	SbSgMs	pendeln	VbIn
Pendler	SbSgMs
Penne	SbSgFmVulg	Schule	SbSgFm
Penner	SbSgMs	pennen	VbIn
Pensen	xx
Pep	xx
Percht	xx
Pergel	xx
Perl	xx
Perle	SbSgFm
Perm	xx
Perser	SbSgMsPersGeogCtry.Ir	Persien	NmGeogCtry.Ir
Perth	NmGeogCityForg.Au
Pesel	xx
Pest	SbSgFmMedc
Peter	NmMsPren
Petz	xx
Petze	SbSgFm
Petzer	SbSgMs	petzen	VbIn
Pfad	SbSgMs
Pfadchen:	SbSgNtDimt	Pfad	SbSgMs
Pfader	xx
Pfaffe	SbSgMsPers
Pfahl	SbSgMs
Pfalz	NmFmGeogRegn
Pfalzer:	SbSgMsGeogRegn	Pfalz	NmFmGeogRegn
Pfand	SbSgNt
Pfander:	xx
Pfannchen:	SbSgNtDimt	Pfanne	SbSgFm
Pfanne	SbSgFm
Pfanner:	xx
Pfarre	SbSgFm
Pfarrer	SbSgMsProf	Pfarre	SbSgFm
Pfau	SbSgMsZool
Pfeffer	SbSgMsNutr
Pfeife	SbSgFm
Pfeifer	NmSurnPers
Pfeil	SbSgMs
Pfeiler	SbSgMs
Pferch	SbSgMs
Pferd	SbSgNtZool
Pfette	xx
Pfiff	SbSgMs	pfeifen	VbInStrg
Pfingsten	SbSgNtTime
Pfingstler	xx
Pfister	NmSurn
Pfitzner	NmSurn
Pflanz	xx
Pflanzchen:	SbSgNtDimtBota	Pflanze	SbSgFmBota
Pflanze	SbSgFmBota
Pflanzer	SbSgMs	pflanzen	VbIn
Pflaster	SbSgNt
Pflatsch	SbSgMsVulg
Pflaumchen:	SbSgNtDimtNutr	Pflaume	SbSgFmNutr
Pflaume	SbSgFmNutr
Pflege	SbSgFm	pflegen	VbInStrg
Pfleger	SbSgMs	pflegen	VbIn
Pflicht	SbSgFm
Pflock	SbSgMs
Pflockchen:	SbSgNtDimt	Pflock	SbSgMs
Pflotsch	xx
Pflucke:	xx
Pflucker:	SbSgMsProf
Pflug	SbSgMs
Pfluger:	SbSgMsProf
Pfortchen:	SbSgNtDimt	Pforte	SbSgFm
Pforte	SbSgFm
Pfortner:	SbSgMsProf
Pfostchen:	SbSgNtDimt	Pfosten	SbSgMs
Pfosten	SbSgMs
Pfotchen:	SbSgNtDimtBody	Pfote	SbSgFmBody
Pfote	SbSgFmBody
Pfriem	SbSgMs
Pfrille	xx
Pfropf	SbSgMs
Pfropfchen:	SbSgNtDimt	Pfropf	SbSgMs
Pfrunde:	SbSgFm
Pfrunder:	xx
Pfrundner:	xx
Pfuhl	SbSgMs
Pfuhl:	xx
Pfulmen	xx
Pfund	SbSgNt
Pfundchen:	SbSgNtDimt	Pfund	SbSgNt
Pfusch	SbSgMs
Pfuscher	SbSgMs	pfuschen	VbIn
Pfutzchen:	SbSgNtDimt	Pfutze:	SbSgFm
Pfutze:	SbSgFm
Phage	xx
Phase	SbSgFmForg.En
Phi	SbSgNtLetrForg.Gr
Phlox	SbSgMsBota
Phobe:	NmFmPren
Phon	SbSgNtMeas
Phosgen	SbSgNtChem
Phot	xx
Phrase	SbSgFmForg.En
Pi	SbSgNtLetrForg.Gr
Pichler	SbSgMs
Pick	xx
Picke	xx
Pickel	SbSgMs	pickeln	VbIn
Piece	xx
Pieck	xx
Piefke	SbSgMsVulg
Piek	xx
Piep	SbSgMs
Piepel	xx
Piepser	SbSgMs	piepsen	VbIn
Pier	SbSgNt
Pierre	NmMsPrenForg.Fr
Pik	SbSgNt
Pike	SbSgFm
Pikser	SbSgMs	piksen	VbIn
Pikte	SbSgMsPers
Pilger	SbSgMsPers
Pilke	xx
Pilker	xx
Pille	SbSgFm
Piller	xx
Pils	SbSgNtNutr
Pilsen	NmGeogCityForg.Cz
Pilz	SbSgMsBota
Pimmel	SbSgMs
Pimpf	SbSgMsPers
Pin	SbSgMsForg.En
Pinge	xx
Pinke	SbSgFmVulg
Pinkel	SbSgMs	pinkeln	VbIn
Pinne	SbSgFm
Pinscher	SbSgMsZool
Pinsel	SbSgMs	pinseln	VbIn
Pinsler	xx
Pint	SbSgFmForg
Pinte	SbSgFm
Pipe	SbSgFmForg.En
Pippe	xx
Pips	xx
Pirsch	SbSgFm
Piss	xx
Pisse	SbSgFm
Pisser	SbSgMsPers	Pisse	SbSgFm
Piste	SbSgFm
Pixel	SbSgNtForg
Piz	SbSgMsGeogMontForg
Plache	xx
Plage	SbSgFm
Plagge	xx
Plaid	SbSgNtForg
Plan	SbSgMs
Planche	xx
Planck	NmSurn
Plane	SbSgFm
Plane:	SbPl	Plan	SbSgMs
Planer	SbSgMsProf
Planer:	xx
Planke	SbSgFm
Plarrer:	SbSgMs
Plast	SbSg
Plaste	SbPl
Plattchen:	SbSgNtDimt	Platte	SbSgFm
Platte	SbSgFm
Platte:	xx
Plattler	SbSgMs
Platz	SbSgMs
Platzchen:	SbSgNtDimt	Platz	SbSgMs
Platze	xx
Platze:	SbPl	Platz	SbSgMs
Plaudrer	xx
Plauen	NmGeogCity.De
Plausch	SbSgMs
Plauz	xx
Plauze	xx
Plebs	SbSgMsVulgForg.Lt
Pleiße	xx
Plempe	SbSgFm
Plente	xx
Plenten	xx
Pleuel	SbSgMs
Pli	xx
Plicht	xx
Plinse	xx
Plinthe	xx
Plinze	xx
Plombe	SbSgFm
Plorre:	xx
Plot	SbSgMsForg.En
Plotter	SbSgMsForg.En
Plotze:	xx
Plumpe	xx
Plumps	Rp
Plunder	SbSgMs
Plundrer:	xx
Plunnen:	xx
Plunze	xx
Plunzen	xx
Plusch:	SbSgMs
Plutzer	xx
Pneu	SbSgMsForg.Fr
Po	SbSgMs
Pobel:	SbSgMs
Poch	xx
Pocke	SbSgFm
Pocken	SbPl	Pocke	SbSgFm
Poe	NmSurnForg.En
Poem	SbSgNtForg.Lt
Poet	SbSgMsPersForg.Lt
Pofel	xx
Pokel:	SbSgMsNutr
Poker	SbSgMsForg
Poker:	xx
Pol	SbSgMs
Polder	SbSgMs
Pole	SbPlMs
Polk:	xx
Pollen	SbPlBota
Poller	SbSgMs
Polster	SbSgNt
Polter	SbSgMs
Pommer	NmGeogFlumForg.Pl
Pomp	SbSgMsForg.Lt
Pond	xx
Ponte	xx
Pop	SbSgMsForg
Pope	SbSgMsPers
Popel	SbSgMsVulg	popeln	VbIn
Popper	NmSurnForg.En
Pore	SbSgFmBody
Porkel:	xx
Porst	NmSurn
Port	SbSgMsForg.En
Porter	xx
Pose	SbSgFm
Posse	SbSgFm
Possen	SbPl	Posse	SbSgFm
Post	SbSgFm
Postchen:	SbSgNtDimt	Posten	SbSgMs
Posten	SbSgMs
Poster	SbSgNtForg.En
Postler	SbSgMsProf
Postler:	xx
Pot	xx
Pott	SbSgMsForg.En
Pra:	xx
Pracher	xx
Pracht	SbSgFm
Pracker	xx
Prag	NmGeogCityForg.Cz
Prager	SbSgMsGeogCityForg.Cz	Prag	NmGeogCityForg.Cz
Prager:	xx
Prahler	SbSgMs	prahlen	VbIn
Prahm	xx
Praller	SbSgMs	prallen	VbIn
Pranger	SbSgMs	prangen	VbIn
Pranke	SbSgFmBody
Pranz	xx
Pranzer	xx
Praser:	xx
Prass	xx
Prasser	SbSgMs	prassen	VbIn
Prater	NmForg.At
Pratze	SbSgFm
Prau	xx
Pregel	NmMsGeogFlum
Preis	SbSgMs	preisen	VbInStrg
Preller	SbSgMs	prellen	VbIn
Presse	SbSgFm
Preuße	SbSgMsGeogRegn
Preußen	NmGeogRegn
Pricke	xx
Prickel	SbSgMs
Priel	SbSgMs
Priem	xx
Priester	xx
Prim	xx
Prime	xx
Primel	SbSgFmBota
Primen	xx
Print	SbSgMsForg
Printe	SbSgFmNutr
Printer	SbSgMsForg.En	Printe	SbSgFmNutr
Prinz	SbSgMsProf
Prischen	SbSgNtDimt	Prise	SbSgFm
Prise	SbSgFm
Pritsche	SbSgFm
Prix	SbSgMsForg.Fr	Preis	SbSgMs
Probchen:	SbSgNtDimt	Probe	SbSgFm
Probe	SbSgFm
Prof	AbTitl	Professor	SbSgMsProf
Proll	xx
Propen	xx
Proppen	xx
Propst	SbSgMsProf
Prost	Rp
Protz	SbSgMs
Protze	xx
Prufer:	SbSgMsProf
Prugel:	SbSgMs
Prunk	SbSgMs
Pruth	xx
Pruße	xx
Psalm	SbSgMs
Psalter	SbSgMs
Psi	SbSgNtLetrForg.Gr
Pta	xx
Ptah	xx
Pu	xx
Pub	SbSgMsForg.En
Puck	SbSgMs
Pud	xx
Pudel	SbSgMsZool
Puder	SbSgMs
Puff	SbSgNt
Puffchen:	SbSgNtDimt
Puffe	xx
Puffer	SbSgMs	puffen	VbIn
Pul	xx
Pulcher:	xx
Pulk	SbSgMsForg.En
Pulle	SbSgFmVulg
Puller	xx
Pulp	xx
Pulpe	xx
Pulpe:	xxDiar
Puls	SbSgMsMedc
Pult	SbSgNt
Pulver	SbSgNt
Pummel	SbSgMsPers
Pump	SbSgMs
Pumpe	SbSgFm
Pumpel:	xx
Pumps	SbPlForg.En
Punch	SbSgMsForg.En
Puncher	xx
Punk	SbSgMsPersForg.En
Punker	SbSgMsPersForg.En	Punk	SbSgMsPersForg.En
Punkt	SbSgMs
Punktchen:	SbSgNtDimt	Punkt	SbSgMs
Punsch	SbSgMsNutr
Punze	SbSgFm
Pup	xx
Pupe	xx
Puppchen:	SbSgNtDimt	Puppe	SbSgFm
Puppe	SbSgFm
Pups	SbSgMsVulg
Pupser	SbSgMsVulg	pupsen	VbInVulg
Purser	xx
Purzel	SbSgMs	purzeln	VbIn
Purzel:	SbSgMsDiar
Puschel	xx
Puschel:	xxDiar
Pusher	SbSgMsForg	pushen	VbIn
Puste	SbSgFm
Pustel	SbSgMs
Pute	SbSgFmZool
Puter	SbSgMsZool	Pute	SbSgFmZool
Putsch	SbSgMsMilt
Putt	xx
Putt:	xxDiar
Putte	SbSgFm
Putter	xx
Putz	SbSgMs
Putz:	xx
Putze	SbSgFm
Putze:	xx
Putzer	SbSgMs	putzen	VbIn
Puzzle	SbSgNtForg.En
Puzzler	xx
Quecke	xx
Queen	SbSgFmPersForg.En	Konigin:	SbSgFmPers
Quell	SbSgMs
Quellchen	SbSgNtDimt	Quelle	SbSgFm
Quelle	SbSgFm
Queller	xx
Quendel	xx
Quengler	SbSgMs
Quent	xx
Quentchen	SbSgNtDimt
Quere	SbSgFm	quer	Aj
Quese	xx
Quetsch	xx
Quetsche	SbSgFm
Ra	xx
Raab	NmSurn
Raabe	NmSurn
Rab	xx
Rabchen:	SbSgNtDimtZool	Rabe	SbSgFmZool
Rabe	SbSgFmZool
Rabe:	xx
Rache	SbSgFm
Rachel	NmFmPren
Rachen	SbSgMs
Racher:	SbSgMsPers
Rack	SbSgNtForg.En
Racke	xx
Racker	SbSgMsPers
Rad	SbSgNt
Radchen:	SbSgNtDimt	Rad	SbSgNt
Rade	xx
Radl	SbSgNtDimtDial
Radler	SbSgMs
Raf:	xx
Raffel	SbSgFm
Raffke	xx
Raft	xx
Rafter	xx
Rag	xx
Rage	SbSgFmForg
Rah	SbSgFm
Rahe	xx
Rahel	NmFmPren
Rahm	SbSgMsNutr
Rahm:	xx
Rahmchen:	SbSgNtDimt	Rahmen	SbSgMs
Rahmen	SbSgMs
Rahne	xx
Raid	xx
Rain	SbSgMs
Rainer	NmMsPren
Rake	xx
Rakel	SbSgMs
Ralf	NmMsPren
Ralle	xx
Ralph	NmMsPren
Ramm	xx
Ramme	SbSgFm
Rammel	SbSgMs
Rammler	SbSgMs
Rampe	SbSgFm
Ramsch	SbSgMs
Ramscher	xx
Ranch	SbSgFmForg.En
Rancher	SbSgMsProfForg.En	Ranch	SbSgFmForg.En
Rand	SbSgMs
Randchen:	SbSgNtDimt	Rand	SbSgMs
Rande	xx
Rander:	SbPl	Rand	SbSgMs
Ranft	xx
Ranftchen:	SbSgNtDimtNutr
Range	SbSgMsForg.En
Ranger	SbSgMsProfForg.En	Range	SbSgMsForg.En
Ranke	SbSgFm
Ranke:	SbSgFmDiar
Ranzchen:	SbSgNtDimt	Ranzen	SbSgMs
Ranzel:	xx
Ranzer	xx
Rap	SbSgMs
Rapfen	xx
Rapp	xx
Rappe	SbSgMsZool
Rappel	SbSgMs	rappeln	VbIn
Rapper	SbSgMsPers
Raps	SbSgMsBota
Ras	xx
Raser	SbSgMs	rasen	VbIn
Raspel	SbSgFm	raspeln	VbIn
Rasse	SbSgFm
Rassel	SbSgFm	rasseln	VbIn
Rassler	xx
Rast	SbSgFm
Raste	SbSgFm
Rastel	xx
Raster	SbSgMs	rasten	VbIn
Rat	SbSgMs
Rat:	xx
Rate	SbSgFm
Rater	SbSgMsPers
Rater:	xx
Ratsche	SbSgFm
Ratsche:	xx
Ratsel:	SbSgNt
Ratte	SbSgFmZool
Ratter:	xx
Rattler	xx
Ratz	SbSgFmVulgZool
Ratze	SbSgFmZool
Ratzel:	xx
Raub	SbSgMs
Rauber:	SbSgMsPers	Raub	SbSgMs
Rauch	SbSgMs
Raucher	SbSgMs	rauchen	VbIn
Raude:	SbSgFm
Raue	xx
Raufe	xx
Raufer	SbSgMs	raufen	VbIn
Rauke	xx
Raum	SbSgMs
Raumchen:	SbSgNtDimt	Raum	SbSgMs
Raumer:	SbSgMs
Raumte:	xx
Raunzer	SbSgMs	raunzen	VbIn
Raupchen:	SbSgNtDimtZool	Raupe	SbSgFmZool
Raupe	SbSgFmZool
Rausch	SbSgMs
Rauscher	NmSurn
Raute	SbSgFm
Rave	xx
Ravel	NmSurn
Raver	SbSgMsPers
Rax	xx
Rebe	SbSgFmBota
Rechner	SbSgMs	rechnen	VbIn
Rechte	SbPl	Recht	SbSgNt
Rechtser	xx
Reck	SbSgNt
Recke	SbSgMsPers
Redder	xx
Rede	SbSgFm	reden	VbIn
Redner	SbSgMsPers	reden	VbIn
Reede	SbSgFm
Reeder	SbSgMsProf	Reede	SbSgFm
Reep	SbSgNt
Reet	SbSgNt
Reff	SbSgNt
Reg	xx
Regel	SbSgFm	regeln	VbIn
Regen	SbSgMsMeto	regnen	VbIn
Reger	NmSurn
Regler	SbSgMs
Regner	xx
Reh	SbSgNtZool
Rehe	SbPl	Reh	SbSgNtZool
Reibe	SbSgFm
Reiber	xx
Reiche	SbSgMsPers	reich	Aj
Reife	SbSgFm	reif	Aj
Reigen	SbSgMs
Reihe	SbSgFm
Reiher	SbSgMs	reihen	VbIn
Reim	SbSgMs
Reims	NmGeogCityForg.Fr
Reimser	xx
Reindl	xx
Reine	SbSgFm
Reiner	NmPrenMs
Reis	SbSgMsNutr
Reise	SbSgFm
Reiste	xx
Reitel	xx
Reiter	SbSgMs	reiten	VbIn
Reiz	SbSgMs
Reizker	SbSgMsBota
Reißer	xx
Rekel	xx
Rempler	SbSgMs
Rempter	xx
Rems	xx
Remter	xx
Renke	xx
Renner	SbSgMs	rennen	VbIn
Rente	SbSgFm
Rentner	SbSgMsPers	Rente	SbSgFm
Rep	SbSgMsPersAbbr	Republikaner	SbSgMsPers
Reps	SbPlPersAbbr	Republikaner	SbSgMsPers
Rest	SbSgMs
Retter	SbSgMs	retten	VbIn
Reue	SbSgFm
Reuse	SbSgFm
Reuter	NmSurn	reuten	VbIn
Reutte	xx
Reutter	xx
Reuß	xx
Reuße	SbSgMsPers
Rhat:	xx
Rhede	xx
Rheidt	NmGeogCity.De
Rhein	NmMsGeogFlum
Rho	SbSgNtLetrForg.Gr
Rhon:	NmGeogMont.De
Rhone	NmGeogFlumForg.Fr
Rhus	xx
Richte	xx
Richter	SbSgMs	richten	VbIn
Rick	xx
Ricke	xx
Riebel	xx
Riecher	SbSgMs	riechen	VbIn
Ried	SbSgNt
Riede	xx
Riefe	SbSgFm
Riege	SbSgFm
Riegel	SbSgMs	riegeln	VbIn
Riemchen	SbSgNtDimt	Riemen	SbSgMs
Riemen	SbSgMs
Riemer	xx
Ries	SbSgNt
Riese	SbSgMsPers
Riester	NmSurn
Rif	xx
Riff	SbSgNtForg
Riffel	SbSgMs	riffeln	VbIn
Rigel	NmGeogCity.De
Rigg	SbSgNt
Rilke	NmSurn
Rille	SbSgFm
Rind	SbSgNtZool
Rinde	SbSgFm
Ring	SbSgMs	ringen	VbInStrg
Ringel	SbSgMs
Ringer	SbSgMs	ringen	VbIn
Rink	xx
Rinke	xx
Rinken	xx
Rinne	SbSgFm
Rippchen	SbSgNtDimtNutr	Rippe	SbSgFmBody
Rippe	SbSgFmBody
Rips	xx
Rispe	SbSgFmBota
Riss	SbSgMs	reißen	VbInStrg
Rist	SbSgMs
Riste	xx
Riten	SbPlForg.Lt	Ritus	SbSgMsForg.Lt
Ritscher	xx
Ritt	SbSgMs	reiten	VbInStrg
Ritter	SbSgMsProf
Ritz	SbSgMs
Ritze	SbSgFm
Ritzel	SbSgMs
Ritzer	xx
Robbe	SbSgFmZool
Robber	xx
Robe	SbSgFm
Rochen	SbSgMsZool
Rock	SbSgMs
Rockchen:	SbSgNtDimt	Rock	SbSgMs
Rocker	SbSgMs	rocken	VbIn
Rodel	SbSgMs	rodeln	VbIn
Roder	NmSurn
Rodler	SbSgMs
Rogen	SbSgMsNutr
Roger	NmMsPrenForg.En
Roggen	SbSgMsNutr
Rohr	SbSgNt
Rohrchen:	SbSgNtDimt	Rohr	SbSgNt
Rohre:	SbSgFm	Rohr	SbSgNt
Rolf	NmMsPren
Rollchen:	SbSgNtDimt	Rolle	SbSgFm
Rolle	SbSgFm
Roller	SbSgMs	rollen	VbIn
Rom	NmGeogCityForg.It
Romer:	SbSgMsGeogCityForg.It	Rom	NmGeogCityForg.It
Ronde	xx
Rosche:	xx
Roschen:	SbSgNtDimtBota	Rose	SbSgFmBota
Rose	SbSgFmBota
Rosschen:	SbSgNtDimtZool	Ross	SbSgNtZool
Rossl:	SbSgNtDimtZoolDial	Ross	SbSgNtZool
Rost	SbSgMs
Roste:	xx
Roster:	SbSgMs
Rot:	xx
Rote:	SbSgFm	rot	Aj
Roteln:	SbPlMedc
Roth	NmSurn
Rotte	SbSgFm
Rotz	SbSgMs
Rotze	SbSgFm
Roß	SbSgNt
Roße	xx
Ru	xx
Rubber	xx
Rubchen:	SbSgNtDimt	Rube:	SbSgFmNutr
Rube:	SbSgFmNutr
Rubel	SbSgMs
Ruben	NmMsPren
Rubren	xx
Rubsen:	xx
Ruch	xx
Ruck:	xx
Rucken:	SbSgMsBody
Rudel	SbSgMs
Ruder	SbSgNt
Rudrer	xx
Ruf	SbSgMs
Rufe:	xx
Rufer	SbSgMs	rufen	VbIn
Ruffel:	SbSgMs
Ruffler:	xx
Ruge:	SbSgFm	rugen:	VbIn
Rugel	SbSgMs
Ruger:	xx
Ruhe	SbSgFm
Ruhm	SbSgMs
Ruhr	SbSgFmMedc
Rulps:	RpVulg
Rulpser:	SbSgMs
Rummel	SbSgMs	rummeln	VbIn
Rumpel	SbSgMs	rumpeln	VbIn
Rumpf	SbSgMsBody
Run	SbSgMsForg.En
Runde	SbSgFm
Runde:	xx
Rune	SbSgFm
Runge	xx
Runkel	SbSgMs
Runken	xx
Runks	xx
Runs	xx
Runse	xx
Runzel	SbSgFm	runzeln	VbIn
Rupel:	SbSgMsPers
Rur	xx
Rus	xx
Rusch	xx
Rusche:	SbSgFm
Ruschel	xx
Russe	SbSgMsPersGeogCtry.Ru
Russel:	SbSgMs
Ruste:	xx
Ruster:	SbSgMsBota
Rut	xx
Rute	SbSgFm
Ruth	NmFmPren
Rutsch	SbSgMs
Rutsche	SbSgFm
Rutte	xx
Ruttler:	SbSgMs	rutteln:	VbIn
Ruwer	NmGeogFlum.De
Ruß	SbSgMs
Saal	SbSgMs
Saale	NmFmGeogFlum
Saane	xx
Saanen	xx
Saar	NmFmGeogFlum
Saat	SbSgFm
Sabbel	xx
Sabber	SbSgMsVulg
Sabel:	SbSgMs
Sabre	SbSgMsTitlForg
Sache	SbSgFm
Sachs	NmSurn
Sachse	SbSgMsPersGeogRegn.De
Sachsen	NmGeogRegn.De
Sack	SbSgMs
Sackchen:	SbSgNtDimt	Sack	SbSgMs
Sackel:	SbSgNtDimtDial	Sack	SbSgMs
Sackler:	xx
Saer:	xx
Safe	SbSgMsForg.En
Saft	SbSgMsNutr
Sage	SbSgFm
Sage:	SbSgFmDiar
Sager	SbSgMs	sagen	VbIn
Sager:	SbSgMsProf
Sahel	NmSurnForg
Sahne	SbSgFmNutr
Saint	SbSgMsForg.Fr
Sainte	SbSgFmForg.Fr
Sais	xx
Saite	SbSgFmMusi
Sake	SbSgMsNutrForg.Jp
Salbe	SbSgFm
Salchen:	SbSgNtDimt	Saal	SbSgMs
Sale:	xx
Salm	SbSgMsZool
Salmler	xx
Salpe	xx
Salse	xx
Salt	xx
Salve	xx
Salz	SbSgNtNutr
Salzer:	xx
Sam	NmMsPrenForg.Us
Same	SbSgMs
Samen	SbPl	Same	SbSgMs
Sammler	SbSgMs
Sample	SbSgNtForg
Sampler	SbSgMsForg
Samt	SbSgMsClth
San	xx
Sand	SbSgMs
Sandler	SbSgMsPersVulg
Sanfte:	SbSgFm
Sang	SbSgMs
Sanger:	SbSgMsPers
Sankt	AbTitlForg.Lt
Sante	xx
Sappe	xx
Sappel	xx
Sarde	SbSgMsGeogRegnForg.It
Sarg	SbSgMs
Sarnen	NmGeogCityForg.Ch
Sartre	NmSurnForg.Fr
Sasse	xx
Satte	xx
Sattel	SbSgMs	satteln	VbIn
Sattler	SbSgMs
Satz	SbSgMs
Satzchen:	SbSgNtDimt	Satz	SbSgMs
Sau	xx
Sauce	SbSgFmNutrForg.Fr
Saufer:	SbSgMsPers
Sauger	SbSgMs	saugen	VbIn
Sauger:	SbSgMsPers
Saul	NmMsPren
Saulchen:	SbSgNtDimt	Saule:	SbSgFm
Saule:	SbSgFm
Saum	SbSgMs
Saumchen:	SbSgNtDimt	Saum	SbSgMs
Saumer:	SbSgMsPers
Saure:	SbSgFmChem
Saus	SbSgMs
Sause	SbSgFm
Sauser	SbSgMs	sausen	VbIn
Save	xx
Sax	NmSurn
Sbirre	xx
Sbrinz	xx
Scanner	SbSgMsForg	scannen	VbIn
Scart	xx
Scat	xx
Scene	xx
Schabe	SbSgFmZool
Schabe:	xx
Schaber	SbSgMs	schaben	VbIn
Schabsel	xx
Schach	SbSgNt
Schachen	xx
Schacher	SbSgMs
Schacher:	SbSgMsPers
Schacht	SbSgMs
Schachtel	SbSgFm	schachteln	VbIn
Schachter:	SbSgMsProf
Schadel:	SbSgMsBody
Schaf	SbSgNtZool
Schafchen:	SbSgNtDimtZool	Schaf	SbSgNtZool
Schafer:	SbSgMsPers	Schaf	SbSgNtZool
Schaff	SbSgNt
Schaffchen:	SbSgNtDimt	Schaff	SbSgNt
Schaffel	xx
Schaffer	SbSgMs	schaffen	VbIn
Schaffler:	xx
Schaffner	SbSgMsProf
Schaft	SbSgMs
Schaftchen:	SbSgNtDimt	Schaft	SbSgMs
Schah	SbSgMsTitl
Schake	xx
Schakel:	xx
Schaker:	SbSgMs
Schalchen:	SbSgNtDimt	Schale	SbSgFm
Schale	SbSgFm
Schalk	SbSgMsPers
Schalke	NmGeogCity.De
Schall	SbSgMs	schallen	VbInStrg
Schalm	xx
Schalte	xx
Schalter	SbSgMs	schalten	VbIn
Scham	SbSgFm
Schande	SbSgFm
Schander:	SbSgMsPers	Schande	SbSgFm
Schank	SbSgMs
Schanke:	SbSgFm	Schank	SbSgMs
Schanker	SbSgMsMedc
Schanze	SbSgFm
Schanzer	xx
Schapf	xx
Schapfe	xx
Schapp	xx
Schappe	xx
Schappel	xx
Schar	SbSgFm
Scharbe	xx
Schare:	SbSgFmGeog
Scharfe:	SbSgFm	scharf	Aj
Scharm	xx
Scharn	xx
Scharpe:	SbSgFm
Scharre	xx
Scharte	SbSgFm
Schatten	SbSgMs
Schatz	SbSgMs
Schatzchen:	SbSgNtDimt	Schatz	SbSgMs
Schatzer:	SbSgMs	Schatz	SbSgMs
Schaub	NmSurn
Schaube	xx
Schauder	xx
Schauer	SbSgMs	schauen	VbIn
Schaufel	SbSgFm	schaufeln	VbIn
Schaufler	SbSgMs
Schaukel	SbSgFm	schaukeln	VbIn
Schaukler	SbSgMs
Schaum	SbSgMs
Schaute	xx
Scheck	SbSgMs
Schecke	SbSgMsZool
Schecken	SbSgMs	schrecken	VbInStrg
Schefe	xx
Scheffel	SbSgMs	scheffeln	VbIn
Scheibchen	SbSgNtDimt	Scheibe	SbSgFm
Scheibe	SbSgFm
Scheich	SbSgMsTitl
Scheide	SbSgFm	scheiden	VbInStrg
Scheik	NmGeogRegn
Schein	SbSgMs	scheinen	VbInStrg
Scheit	SbSgNt
Scheitel	SbSgMs	scheiteln	VbIn
Scheiß	SbSgMsVulg
Scheißer	SbSgMs	scheißen	VbIn
Schekel	SbSgMs
Schelch	xx
Schelde	NmFmGeog
Schelf	SbSgNt
Schelfe	xx
Schelle	SbSgFm
Schelm	SbSgMsPers
Schelte	SbSgFm	schelten	VbInStrg
Schemel	SbSgMs
Schemen	SbSgMs
Schenk	SbSgMs
Schenke	SbSgFm
Schenkel	SbSgMs
Schenker	NmSurn
Scherbe	SbSgFm
Scherbel	xx
Scherben	SbPl	Scherbe	SbSgFm
Schere	SbSgFm
Scherer	NmSurn
Scherge	SbSgMsPers
Scherz	SbSgMs
Scherzl	xx
Scheuche	SbSgFm	scheuchen	VbIn
Scheuer	SbSgMs	scheuen	VbIn
Scheune	SbSgFm
Schi	SbSgMs
Schicht	SbSgFm
Schichte	xx
Schickse	SbSgFmVulg
Schieber	SbSgMs	schieben	VbIn
Schiefe	SbSgFm
Schiefer	SbSgMs
Schiele	NmSurn
Schiene	SbSgFm
Schiet	xx
Schießer	NmSurn
Schiff	SbSgNt
Schiffchen	SbSgNtDimt	Schiff	SbSgNt
Schiffer	SbSgMs	schiffen	VbIn
Schifter	xx
Schilcher	xx
Schild	SbSgMs
Schilf	SbSgNt
Schilfe	xx
Schill	NmSurn
Schiller	NmSurn
Schilten	xx
Schimmel	SbSgMs	schimmeln	VbIn
Schimmer	SbSgMs
Schimpf	SbSgMs	schimpfen	VbIn
Schimpfer	SbSgMs	schimpfen	VbIn
Schindel	SbSgMs	schindeln	VbIn
Schinder	SbSgMs	schinden	VbIn
Schinkel	NmSurn
Schinken	SbSgMsNutr
Schinn	xx
Schinne	xx
Schippchen	SbSgNtDimt	Schippe	SbSgFm
Schippe	SbSgFm
Schirm	SbSgMs
Schirmer	NmSurn
Schiss	SbSgMsVulg
Schisser	xx
Schlabber	SbSgMsVulg
Schlacht	SbSgFm	schlachten	VbIn
Schlachter	SbSgMsProf
Schlachter:	SbSgMsPers
Schlacke	SbSgFm
Schlaf	SbSgMs
Schlafchen:	SbSgNtDimt	Schlaf	SbSgMs
Schlafe:	SbSgFmBody
Schlafer:	SbSgMsPers	Schlaf	SbSgMs
Schlag	SbSgMs
Schlage	xx
Schlagel:	SbSgMs	Schlag	SbSgMs
Schlager	SbSgMs
Schlager:	SbSgMsDiar
Schlaks	xx
Schlamm	SbSgMs
Schlamp	SbSgMsVulg
Schlampe	SbSgFmPers
Schlamper	SbSgMs	schlampen	VbIn
Schlange	SbSgFmZool
Schlankel	xx
Schlapfen	xx
Schlappchen:	SbSgNtDimt
Schlappe	SbSgFm
Schlarpe	xx
Schlaube	xx
Schlauch	SbSgMs
Schlauder	xx
Schlaue:	SbSgFm	schlau	Aj
Schlaufe	SbSgFm
Schleck	xx
Schlecker	SbSgMs	schlecken	VbIn
Schlegel	SbSgMs
Schlehe	SbSgFmBota
Schlei	xx
Schleiche	SbSgFmZool
Schleicher	SbSgMs	schleichen	VbIn
Schleie	SbSgFmZool
Schleier	SbSgMs
Schleife	SbSgFm
Schleifer	SbSgMs	schleifen	VbIn
Schleim	SbSgMs
Schleimer	SbSgMs	schleimen	VbIn
Schleiz	NmGeogCity.de
Schleizer	SbSgMsGeogCity.De	Schleiz	NmGeogCity.De
Schleiße	xx
Schlemmer	SbSgMs	schlemmen	VbIn
Schlempe	SbSgFm
Schlenge	xx
Schlenke	xx
Schlenker	SbSgMs
Schlenzer	SbSgMs
Schlepp	xx
Schleppe	SbSgFm
Schlepper	SbSgMs	schleppen	VbIn
Schleuder	SbSgFm	schleudern	VbIn
Schleudrer	xx
Schleuse	SbSgFm	schleusen	VbIn
Schlich	SbSgMs
Schliche	SbPl	Schlich	SbSgMs
Schlichte	SbSgFm	schlicht	Aj
Schlichter	SbSgMs	schlichten	VbIn
Schlick	SbSgMs
Schliefer	xx
Schlieffen	xx
Schlier	xx
Schliere	SbSgFm
Schließe	SbSgFm
Schließer	SbSgMs	schließen	VbIn
Schliff	SbSgMs	schleifen	VbInStrg
Schlinge	SbSgFm	schlingen	VbInStrg
Schlingel	SbSgMs
Schlipf	xx
Schlipp	xx
Schlippe	xx
Schlipper	xx
Schlips	SbSgMs
Schliss	SbSgMs	schleißen	VbInStrg
Schlittel	xx
Schlitz	SbSgMs
Schlogel:	xx
Schlorre	xx
Schloss		SbSgNt
Schlosschen:	SbSgNtDimt	Schloss	SbSgNt
Schlosser	SbSgMsProf
Schlot	SbSgMs
Schlotte	xx
Schloße	SbSgFm
Schlucht	SbSgFm
Schluchzer	SbSgMs	schluchzen	VbIn
Schluck	SbSgMs
Schluckchen:	SbSgNtDimt	Schluck	SbSgMs
Schlucker	SbSgMs	schlucken	VbIn
Schluckser	xx
Schluff	xx
Schluft	xx
Schlummer	SbSgMs
Schlumpf	SbSgMs
Schlumps	xx
Schlund	SbSgMsBody
Schlunze	xx
Schlup	xx
Schlupf	SbSgMs
Schlupfer:	SbSgMs
Schluppe	xx
Schlurfer	SbSgMs	schlurfen	VbIn
Schlurfer:	SbSgMsDiar
Schluse	xx
Schluss	SbSgMs	schließen	VbInStrg
Schlussel:	SbSgMs	schliessen	VbIn
Schmach	SbSgFm
Schmack	xx
Schmacke	xx
Schmadder	xx
Schmah:	SbSgMsVulg
Schmalte	xx
Schmalz	SbSgMsNutr
Schmalze:	xx
Schmalzler	SbSgMs
Schmand	SbSgMsNutr
Schmarre	xx
Schmarren	SbSgMsVulg
Schmarrn	SbSgMsVulg
Schmasche	xx
Schmatz	SbSgMs
Schmatzchen:	SbSgNtDimt	Schmatz	SbSgMs
Schmatzer:	xx
Schmauch	SbSgMs
Schmaus	SbSgMs
Schmeichler	SbSgMs
Schmelz	SbSgMs
Schmelze	SbSgFm	schmelzen	VbIn
Schmelzer	SbSgMsProf
Schmerle	xx
Schmerz	SbSgMs
Schmetten	xx
Schmicke	xx
Schmied	SbSgMsProf
Schmiede	SbSgFm	schmieden	VbIn
Schmiege	xx
Schmiele	xx
Schmiere	SbSgFm
Schmierer	SbSgMs	schmieren	VbIn
Schminke	SbSgFm	schminken	VbIn
Schmirgel	SbSgMs	schmirgeln	VbIn
Schmiss	SbSgMs	schmeißen	VbInStrg
Schmitz	xx
Schmitze	xx
Schmock	xx
Schmok	xx
Schmoker:	SbSgMs
Schmolle	xx
Schmolln:	xx
Schmu	SbSgMsVulg
Schmuddel	SbSgMs	schmuddeln	VbIn
Schmuggel	SbSgMs	schmuggeln	VbIn
Schmuggler	SbSgMs
Schmus	SbSgMs
Schmuser	SbSgMs	schmusen	VbIn
Schmutt	xx
Schmutz	SbSgMs
Schnabel	SbSgMs
Schnack	SbSgMsVulg
Schnake	SbSgFmZool
Schnallchen:	SbSgNtDimt	Schnalle	SbSgFm
Schnalle	SbSgFm
Schnalzer	SbSgMs	schnalzen	VbIn
Schnappchen:	SbSgNtDimt
Schnapper	SbSgMs	schnappen	VbIn
Schnapper:	xx
Schnaps	SbSgMs
Schnapschen:	SbSgNtDimt	Schnaps	SbSgMs
Schnarcher	SbSgMs	schnarchen	VbIn
Schnarre	SbSgFm
Schnat	xx
Schnate	xx
Schnatel:	xx
Schnatz	xx
Schnau	xx
Schnauf	xx
Schnaufer	SbSgMs	schnaufen	VbIn
Schnaupe	xx
Schnauz	SbSgMs
Schnauzchen:	SbSgNtDimtBody	Schnauze	SbSgFmBody
Schnauze	SbSgFmBody
Schnauzer	SbSgMs	schnauzen	VbIn
Schneck	SbSgNt
Schnecke	SbSgFm
Schnee	SbSgMs
Schnegel	xx
Schneid	SbSgMs
Schneide	SbSgFm
Schneider	SbSgMs	schneiden	VbIn
Schneifel	xx
Schneise	SbSgFm
Schnelle	SbSgFm
Schneller	xx
Schnepfe	SbSgFmZool
Schneppe	xx
Schnepper	xx
Schneuze	SbSgFm	schneuzen	VbIn
Schneuß	xx
Schniepel	xx
Schnipfel	SbSgMs	schnipfeln	VbIn
Schnippchen	xx
Schnippel	SbSgMs	schnippeln	VbIn
Schnipsel	SbSgMs	schnipseln	VbIn
Schnitt	SbSgMs
Schnitte	SbSgFm
Schnitter	SbSgMsProf
Schnitz	SbSgMs	schnitzen	VbIn
Schnitzel	SbSgNt	schnitzeln	VbIn
Schnitzer	SbSgMs	schnitzen	VbIn
Schnitzler	NmSurn
Schnodder	xx
Schnorchel	SbSgMs	schnorcheln	VbIn
Schnorkel:	SbSgMs
Schnorrer	SbSgMs	schnorren	VbIn
Schnosel:	SbSgMsPers
Schnucke	xx
Schnuffler:	SbSgMsPers	schnuffeln:	VbIn
Schnuller	SbSgMs
Schnulze	SbSgFm
Schnupfer	SbSgMs	schnupfen	VbIn
Schnur	SbSgFm
Schnurchen:	SbSgNtDimt	Schnur	SbSgFm
Schnurre	SbSgFm
Schnutchen:	SbSgNtDimtBody	Schnute	SbSgFmBody
Schnute	SbSgFmBody
Schober	xx
Schochen	xx
Schock	SbSgMs
Schocker	SbSgMs	schocken	VbIn
Schof	xx
Schoffe:	SbSgMsProf
Scholle	SbSgFm
Schone:	SbSgFmPers
Schoner	SbSgMs	schonen	VbIn
Schopf	SbSgMsBody
Schopfchen:	SbSgNtDimtBody	Schopf	SbSgMsBody
Schopfe:	xx
Schopfer:	SbSgMs
Schoppchen:	SbSgNtDimtNutr	Schoppen	SbSgMsNutr
Schoppe:	xx
Schops:	xx
Schopschen:	xx
Schorf	SbSgMs
Schorl:	xx
Schorle	SbSgNt
Schose	SbSgFmVulg
Schosser	xx
Schot	SbSgNt
Schotchen:	SbSgNtDimt	Schote	SbSgFm
Schote	SbSgFm
Schott	SbSgNt
Schotte	SbSgMsGeogRegn
Schotten	SbPl	Schotte	SbSgMsGeogRegn
Schotter	SbSgMs
Schoß	SbSgMsBody
Schoßchen:	SbSgNtDimtBody	Schoß	SbSgMsBody
Schoßel:	xx
Schraffe	xx
Schrage:	SbSgFm	schrag:	Aj
Schram	xx
Schramme	SbSgFm	schrammen	VbIn
Schrank	SbSgMs
Schrankchen:	SbSgNtDimt	Schrank	SbSgMs
Schranke	SbSgFm
Schranken	SbPl	Schranke	SbSgFm
Schranne	xx
Schranz	SbSgMs
Schranze	SbSgFm
Schrape	xx
Schrapper	SbSgMs	schrappen	VbIn
Schrapsel	xx
Schrat	SbSgMsPers
Schratel:	xx
Schratte	xx
Schraubchen:	SbSgNtDimt	Schraube	SbSgFm
Schraube	SbSgFm
Schraubel	xx
Schrauber	SbSgMs	schrauben	VbIn
Schreck	SbSgMs
Schrecke	xx
Schredder	SbSgMs
Schrei	SbSgMs	schreien	VbInStrg
Schreibe	SbSgFm	schreiben	VbIn
Schreiber	SbSgMs	schreiben	VbIn
Schreier	SbSgMs	schreien	VbIn
Schrein	SbSgMs
Schreiner	SbSgMsProf
Schrenz	xx
Schrieb	SbSgMs	schreiben	VbInStrg
Schriebs	xx
Schrift	SbSgFm
Schriften	SbPlAc	Schrift	SbSgFm
Schrimp	SbSgMsNutr
Schrippe	SbSgFmNutr
Schritt	SbSgMs	schreiten	VbInStrg
Schrofen	xx
Schroffen	xx
Schropfer:	SbSgMs	schropfen:	VbIn
Schrot	SbSgMs
Schroter:	xx
Schrott	SbSgMs
Schrubber	SbSgMs	schrubben	VbIn
Schrulle	SbSgFm
Schrumpel	SbSgMs
Schrund	xx
Schrunde	xx
Schruz	xx
Schtetl	xx
Schub	SbSgMs
Schuber	SbSgMs
Schubs	SbSgMs	Schub	SbSgMs
Schuffel	xx
Schuft	SbSgMsPers
Schuh	SbSgMs
Schuhchen	SbSgNtDimt	Schuh	SbSgMs
Schuhchen:	SbSgNtDimtDiar	Schuh	SbSgMs
Schuld	SbSgFm
Schuldner	SbSgMsPers	Schuld	SbSgFm
Schule	SbSgFm
Schuler:	SbSgMsPers	Schule	SbSgFm
Schulp	xx
Schulter	SbSgFmBody
Schulze	NmSurn
Schummel	SbSgMs	schummeln	VbIn
Schummer	xx
Schummler	SbSgMs
Schund	SbSgMs	schinden	VbInStrg
Schupf	SbSgMsDial
Schupfer	xx
Schupp	NmSurn
Schuppchen:	SbSgNtDimt	Schuppe	SbSgFm
Schuppe	SbSgFm
Schuppe:	xx
Schuppel:	xx
Schups	xx
Schur	SbSgFm
Schurer:	xx
Schurf	xx
Schurfer:	SbSgMs
Schurke	SbSgMsPers
Schurre	xx
Schurz	SbSgMs
Schurze:	SbSgFm	Schurz	SbSgMs
Schuss	SbSgMs
Schussel	SbSgMsPers
Schussel:	SbSgFm
Schusser	SbSgMs
Schussler	SbSgMs
Schuster	SbSgMs
Schute	xx
Schutt	SbSgMs
Schutte:	SbSgFm
Schutz	SbSgMs
Schutz:	NmSurn
Schutze:	SbSgMsPers
Schutzer:	SbSgMs	Schutz	SbSgMs
Schwabber	xx
Schwabe	SbSgMsGeogRegn
Schwaben	NmGeogRegn
Schwache:	SbSgFm	schwach	Aj
Schwade	SbSgFm
Schwaden	SbPl	Schwade	SbSgFm
Schwager	SbSgMsPers
Schwaher:	xx
Schwaige	xx
Schwaiger	NmSurn
Schwalbchen:	SbSgNtDimtZool	Schwalbe	SbSgFmZool
Schwalbe	SbSgFmZool
Schwalk	xx
Schwall	SbSgMs
Schwalm	xx
Schwalmer:	xx
Schwamm	SbSgMs
Schwammchen:	SbSgNtDimt	Schwamm	SbSgMs
Schwan	SbSgMsZool
Schwanchen:	SbSgNtDimtZool	Schwan	SbSgMsZool
Schwanz	SbSgMsBody
Schwanzchen:	SbSgNtDimtBody	Schwanz	SbSgMsBody
Schwanzer:	SbSgMsPers
Schwapp	xx
Schwaps	SbSgMsVulg
Schware:	SbSgFmMedc
Schwarm	SbSgMs
Schwarmer:	SbSgMsPers	Schwarm	SbSgMs
Schwarte	SbSgFmNutr
Schwarze	SbSgMsPers
Schwarze:	SbSgMs	schwarz	AjColr
Schwarzer:	xx
Schwatz	SbSgMs
Schwatzchen:	SbSgNtDimt	Schwatz	SbSgMs
Schwatzer:	SbSgMsPers	Schwatz	SbSgMs
Schwaz	xx
Schwebe	SbSgFm	schweben	VbIn
Schwede	SbSgMsGeogCtry.Se
Schweden	NmGeogCtry.Se	Schwede	SbSgMsPersGeogCtry.Se
Schwefel	SbSgMsChem	schwefeln	VbIn
Schwegel	xx
Schwegler	xx
Schweif	SbSgMs
Schweiger	SbSgMs	schweigen	VbIn
Schwein	SbSgNtZool
Schweitzer	NmSurn
Schweiz	NmGeogCtry.Ch
Schweizer	SbSgMsPersGeogCtry.Ch	Schweiz	NmGeogCtry.Ch
Schweiß	SbSgMs
Schweißer	SbSgMs	schweißen	VbIn
Schwejk	NmSurn
Schwelger	SbSgMs	schwelgen	VbIn
Schwelle	SbSgFm	schwellen	VbInStrg
Schweller	SbSgMs	schwellen	VbIn
Schwemme	SbSgFm	schwemmen	VbIn
Schwemmsel	xx
Schwende	xx
Schwengel	SbSgMs
Schwenk	SbSgMs	schwenken	VbIn
Schwenker	SbSgMs	schwenken	VbIn
Schwere	SbSgFm	schwer	Aj
Schwert	SbSgNtMilt
Schwester	SbSgFmPers
Schwiegel	xx
Schwieger	xx
Schwiele	SbSgFm
Schwiemel	SbSgMs
Schwimmer	SbSgMs	schwimmen	VbIn
Schwindel	SbSgMs	schwindeln	VbIn
Schwindler	SbSgMs
Schwinge	SbSgFm	schwingen	VbIn
Schwingel	xx
Schwinger	SbSgMs	schwingen	VbIn
Schwippe	xx
Schwips	SbSgMs
Schwirl	xx
Schwitze	SbSgFm	schwitzen	VbIn
Schwof	SbSgMsVulg
Schwuchtel	SbSgFm
Schwule	SbSgMsPers
Schwule:	SbSgFm
Schwulst	xx
Schwund	SbSgMs	schwinden	VbInStrg
Schwung	SbSgMs	schwingen	VbInStrg
Schwupp	Rp
Schwups	SbSgMsVulg
Schwur	SbSgMs	schworen:	VbInStrg
Score	SbSgMsForg.En
Scotch	SbSgMsNutrForg.En
Scott	NmSurnForg.En
Scrip	xx
Sech	xx
Sechser	SbSgMs
Sechter	xx
See	SbSgMs
Seelchen	SbSgNtDimt	Seele	SbSgFm
Seele	SbSgFm
Segel	SbSgNt	segeln	VbIn
Segen	SbSgMs
Seger	xx
Segge	xx
Segler	SbSgMs
Seher	SbSgMs	sehen	VbIn
Sehne	SbSgFmBody
Seiber	xx
Seich	SbSgMsVulg
Seiche	SbSgFmVulg
Seide	SbSgFmClth
Seidel	SbSgMs
Seife	SbSgFm
Seifer	xx
Seiffen	xx
Seifner	xx
Seige	xx
Seihe	xx
Seiher	SbSgMs	seihen	VbIn
Seil	SbSgNt
Seiler	NmSurn
Seim	xx
Seite	SbSgFm
Sejm	xx
Sekel	xx
Sekt	SbSgMsNutr
Sekte	SbSgFm
Selcher	xx
Selen	SbSgNtChem
Sem	xx
Semmel	SbSgFm
Semper	xx
Send	xx
Sender	SbSgMs	senden	VbIn
Senf	SbSgMsNutr
Senge	SbSgFm	sengen	VbIn
Senke	SbSgFm	senken	VbIn
Senkel	SbSgMs
Senker	SbSgMs	senken	VbIn
Senn	SbSgMsProf
Senne	SbSgMsProf
Senner	SbSgMs	sennen	VbIn
Sense	SbSgFm
Sepp	NmMsPrenDial
Seppel	NmMsPrenDimt
Serbe	SbSgMsPersGeogRegn	Serbien	NmGeogCtry.Yu
Seren	xx
Serge	NmMsPrenForg.Fr
Sernf	xx
Serpel	xx
Server	SbSgMsForg.En
Sesel	xx
Sessel	SbSgMs
Sester	xx
Set	SbSgNtForg.En
Seth	xx
Setter	SbSgMsZool
Setzer	SbSgMs	setzen	VbIn
Seuche	SbSgFm
Seufzer	SbSgMs	seufzen	VbIn
Sex	SbSgMsForg.Lt
Sext	xx
Sexte	SbSgFmMusi
Sfor	SbSgFmAbbr
Shag	xx
Shake	SbSgMsForg.En
Shaker	SbSgMsForg.En
Share	SbSgMsForg.En
Shaw	xx
Shirt	SbSgNtForg.En
Shit	SbSgMsForg.En
Shop	SbSgMsForg.En
Shorts	SbPlForg.En
Show	SbSgFmForg.En
Shredder	SbSgMsForg.En
Shrimp	SbSgNutrMsForg.En
Shunt	SbSgMsForg.En
Shuttle	SbSgNtForg
Sichel	SbSgFm	sicheln	VbIn
Sichler	xx
Sicht	SbSgFm
Sicke	xx
Sieb	SbSgNt
Siede	xx
Sieder	SbSgMs	sieden	VbIn
Siedler	SbSgMs
Sieg	SbSgMs
Siegel	SbSgNt	siegeln	VbIn
Sieger	SbSgMs	siegen	VbIn
Sieke	xx
Siel	SbSgNt
Siele	SbSgFm	sielen	VbIn
Sielen	SbPl	Siel	SbSgNt
Sif	xx
Sigel	SbSgNtForg
Sigle	xx
Sikh	SbSgMsPersForg.In
Silbe	SbSgFm
Silber	SbSgNtMetl
Sild	xx
Silen	xx
Silge	xx
Silke	NmFmPren
Sillen	xx
Simmer	NmSurn
Sims	SbSgNt
Simse	SbPl	Sims	SbSgNt
Single	SbSgMsForg
Sinn	SbSgMs	sinnen	VbInStrg
Sinter	SbSgMsMetl
Sippe	SbSgFm
Sir	NmTitlForg.En
Sire	NmTitlForg.Fr
Site	SbSgFmForg.En
Sitte	SbSgFm
Sitten	SbPl	Sitte	SbSgFm
Sitz	SbSgMs	sitzen	VbInStrg
Skalde	xx
Skale	SbSgFm
Skalp	SbSgMsForg.En
Skarn	xx
Skat	SbSgMs
Skater	SbSgMsForg	skaten	VbIn
Sketch	SbSgMsForg.En
Sketsch	xx
Ski	SbSgMs
Skiff	xx
Skin	SbSgMsForg.En
Skink	xx
Skipper	SbSgMsProf
Skizze	SbSgFm
Sklave	SbSgMsPers
Skop	xx
Skopje	NmGeogCityForg.Yu
Skopze	xx
Skore	xx
Skote	xx
Skript	SbSgNtForg.En
Skrupel	SbSgMs
Skudde	xx
Skuld	xx
Skull	xx
Skuller	SbSgMsForg
Skunk	SbSgMsZoolForg.En
Skus:	xx
Slang	SbSgMsForg.En
Slash	SbSgMsForg.En
Slawe	SbSgMsPersGeogForg	Slawien	NmGeogRegn
Slice	SbSgNtForg.En
Slick	xx
Slip	SbSgMsForg.En
Slipper	xx
Slot	SbSgMsForg.En
Slum	SbSgMsForg.En
Slup	xx
Smalte	xx
Smash	xx
Smog	SbSgMsForg.En
Smutje	SbSgMsProf
Snack	xx
Snob	SbSgMsPersForg.En
Sockchen:	SbSgNtDimt	Socken	SbSgMs
Socke	SbSgFm
Sockel	SbSgMs
Socken	SbSgMs
Sod	xx
Sode	xx
Soest	NmGeogCity.De
Soester	SbSgMsGeogCity.De	Soest	NmGeogCity.De
Sog	SbSgMs	saugen	VbInStrg
Sohle	SbSgFm
Sohn	SbSgMsPers
Sohnchen:	SbSgNtDimtPers	Sohn	SbSgMsPers
Sohre:	xx
Sold	SbSgMs
Soldner:	SbSgMsProf	Sold	SbSgMs
Sole	SbSgFm
Soll	SbSgNt
Soller:	xx
Solper	xx
Sommer	SbSgMsTime
Sonde	SbSgFm
Song	SbSgMsForg.En
Sonne	SbSgFmAstr
Sorbe	SbSgMsPersGeog
Sore	xx
Sorge	SbSgFm
Sorte	SbSgFm
Sorten	SbPl	Sorte	SbSgFm
Soter	xx
Sott	xx
Soße	SbSgFmNutr
Spa	NmGeogCityForg.Be
Spachtel	SbSgMs	spachteln	VbIn
Spaer	xx
Spaher:	SbSgMsPers
Spake	xx
Spalt	SbSgMs
Spaltchen:	SbSgNtDimt	Spalt	SbSgMs
Spalte	SbSgFm
Spam	SbSgMsForg.En
Spammer	SbSgMsPersForg.En
Span	SbSgMs
Spanchen:	SbSgNtDimt	Span	SbSgMs
Spangchen:	SbSgNtDimt	Spange	SbSgFm
Spange	SbSgFm
Spanne	SbSgFm	spannen	VbIn
Spanner	SbSgMs	spannen	VbIn
Spant	SbSgMsBody
Sparer	SbSgMs	sparen	VbIn
Spargel	SbSgMsNutr
Spark	xx
Sparre	SbSgFm
Spart	xx
Sparte	SbSgFm
Spate:	xx
Spatel	SbSgMs
Spaten	SbSgMs
Spatz	SbSgMsZool
Spatzchen:	SbSgNtDimtZool	Spatz	SbSgMsZool
Spatzle:	SbSgNtNutr
Spaß	SbSgMs
Spaßchen:	SbSgNtDimt	Spaß	SbSgMs
Specht	SbSgMsZool
Speck	SbSgMsNutr
Speech	SbSgMsForg.En
Speed	SbSgMsForg.En
Speer	SbSgMs
Speiche	SbSgFm
Speichel	SbSgMs	speicheln	VbIn
Speicher	SbSgMs
Speik	xx
Speil	xx
Speis	SbSgMs
Speise	SbSgFmNutr
Spektren	xx
Spelt	xx
Spelz	xx
Spelze	SbSgFm
Spencer	NmMsPrenForg.Us
Spende	SbSgFm	spenden	VbIn
Spender	SbSgMs	spenden	VbIn
Spengler	SbSgMsProf
Spenser	xx
Spenzer	xx
Sperber	SbSgMsZool
Spermen	SbPlBodyForg.Lt
Sperre	SbSgFm	sperren	VbIn
Spesen	SbPl
Sphare:	SbSgFmForg.Gr
Sphinkter	xx
Sphinx	NmPersForg.Eg
Spick	xx
Spickel	xx
Spicker	SbSgMs	spicken	VbIn
Spider	SbSgMsForg.En
Spiegel	SbSgMs	spiegeln	VbIn
Spieker	SbSgMs
Spiel	SbSgNt
Spieler	SbSgMs
Spier	xx
Spierchen	xx
Spiere	xx
Spieß	SbSgMs
Spießer	SbSgMs	spießen	VbIn
Spike	xx
Spill	xx
Spille	SbSgFm
Spin	SbSgMsForg.En
Spind	SbSgMs
Spindel	SbSgFm
Spinne	SbSgFm	spinnen	VbInStrg
Spinner	SbSgMs	spinnen	VbIn
Spint	xx
Spirkel	xx
Spirre	xx
Spissen	xx
Spittel	xx
Spittler	SbSgMs
Spitzel	SbSgMs	spitzeln	VbIn
Spitzer	SbSgMs	spitzen	VbIn
Spleen	SbSgMsForg.En
Spleiß	SbSgMs
Spleiße	xx
Spließ	xx
Splint	SbSgMs
Spliss	xx
Split	SbSgMsForg.En
Splitt	SbSgMsForg.En
Splitter	SbSgMs	splitten	VbIn
Splugen:	NmGeogCityForg.Ch
Spoerl	NmSurn
Spor	xx
Spore	SbSgFm
Sporen	SbPl	Spore	SbSgFm
Sporgel:	xx
Sporn	SbSgMs
Sport	SbSgMs
Sportel	xx
Sportler	SbSgMsProf
Spot	SbSgMsForg.En
Spott	SbSgMs
Spotter:	SbSgMsPers	Spott	SbSgMs
Sprache	SbSgFm	sprechen	VbIn
Sprecher	SbSgMs	sprechen	VbIn
Spree	NmGeogFlum.De
Sprehe	xx
Spreite	xx
Spreize	SbSgFm	spreizen	VbIn
Spreißel	SbSgMs
Sprengel	SbSgMs
Sprengsel	SbSgMs
Sprenkel	SbSgMs	sprenkeln	VbIn
Spreu	SbSgFm
Spriegel	xx
Spriet	xx
Sprieße	xx
Sprießel	xx
Spring	xx
Springer	SbSgMs	springen	VbIn
Sprinkler	SbSgMs
Sprint	SbSgMsForg.En
Sprinter	SbSgMsForg	sprinten	VbIn
Sprit	SbSgMsForg.En
Spritze	SbSgFm	spritzen	VbIn
Spritzer	SbSgMs	spritzen	VbIn
Spross	SbSgMs
Sprosschen:	SbSgNtDimt	Spross	SbSgMs
Sprosse	SbSgFm
Sprosser	xx
Sprotte	SbSgFmZool
Spruch	SbSgMs	sprechen	VbInStrg
Sprudel	SbSgMs	sprudeln	VbIn
Sprudler	xx
Sprue	xx
Sprung	SbSgMs	springen	VbInStrg
Spucke	SbSgFmBody	spucken	VbIn
Spuk	SbSgMs
Spule	SbSgFm
Spule:	SbSgFmDiar	spulen:	VbIn
Spuler	xx
Spuler:	SbSgMsProf	spulen:	VbIn
Spund	SbSgMs
Spunten	xx
Spur	SbSgFm
Spurer:	xx
Spurt	SbSgMsForg.En
Staat	SbSgMs
Stab	SbSgMs
Stabchen:	SbSgNtDimt	Stab	SbSgMs
Stachel	SbSgMs	stacheln	VbIn
Stack	SbSgMsForg.En
Stadel	SbSgMs
Staden	xx
Stadt	SbSgFm
Stadtchen:	SbSgNtDimt	Stadt	SbSgFm
Stadter:	SbSgMsPers	Stadt	SbSgFm
Stafel	xx
Staffel	SbSgMs
Stag	xx
Stage	SbSgForg.En
Stahl	SbSgMsMetl
Stake	xx
Stalker	SbSgMsPersForg.En
Stall	SbSgMs
Stallchen:	SbSgNtDimt	Stall	SbSgMs
Stamm	SbSgMs
Stammchen:	SbSgNtDimt	Stamm	SbSgMs
Stammler	xx
Stampe	xx
Stamper	xx
Stampfe	SbSgFm	stampfen	VbIn
Stampfer	SbSgMs	stampfen	VbIn
Stan	xx
Stand	SbSgMs	stehen	VbIn
Standchen:	SbSgNtDimt	Stand	SbSgMs
Stande	xx
Stande:	SbPl	Stand	SbSgMs
Standel:	xx
Standen	xx
Standen:	SbPlAc	Stand	SbSgMs
Stander	SbSgMs
Stander:	SbSgMsDiar	stehen	VbIn
Standl	SbSgNtDimtDial
Standler	xx
Stange	SbSgFm
Stangel:	SbSgMs
Stanker:	SbSgMsPers	stinken	VbIn
Stans	xx
Stanze	SbSgFm
Stapel	SbSgMs	stapeln	VbIn
Stapfe	xx
Stapler	SbSgMs
Staps	xx
Star	SbSgMsForg
Star:	xx
Starke:	SbSgFm	stark	Aj
Starre	SbSgFm	starr	Aj
Start	SbSgMs
Starter	SbSgMsForg	starten	VbIn
Stase	xx
Statte:	SbSgFm
Stau	SbSgMs
Staub	SbSgMs
Staubchen:	SbSgNtDimt	Staub	SbSgMs
Stauche	xx
Staucher	SbSgMs	stauchen	VbIn
Staude	SbSgFmBota
Stauer	SbSgMs	stauen	VbIn
Stauf	xx
Staufe	SbSgMsPers
Staufer	SbSgMsPers
Staupe	SbSgFmMedc
Stecher	SbSgMs	stechen	VbIn
Stecker	SbSgMs	stecken	VbIn
Steepler	xx
Steffen	NmMsPren
Steg	SbSgMs
Steher	SbSgMs	stehen	VbIn
Stehler	SbSgMs
Steife	SbSgFm	steif	Aj
Steig	xx
Steige	SbSgFm	steigen	VbInStrg
Steiger	SbSgMs	steigen	VbIn
Steile	SbSgFm	steil	Aj
Stein	SbSgMs
Steiper	xx
Steirer	SbSgMsGeogRegnForg.At	Steiermark	NmGeogRegnForg.At
Steiß	SbSgMsBody
Stek	xx
Stele	SbSgFmForg
Stelle	SbSgFm
Steller	SbSgMs	stellen	VbIn
Stelze	SbSgFm	stelzen	VbIn
Stemme	xx
Stempel	SbSgMs	stempeln	VbIn
Stempen	xx
Stendel	xx
Stenge	xx
Stengel	SbSgMs
Stent	SbSgMsForg.En
Stenz	xx
Step	SbSgMsForg.En
Stepp	SbSgMsClth	steppen	VbIn
Steppe	SbSgFm
Stepper	SbSgMs	steppen	VbIn
Steppke	SbSgMsPersDimt
Sterke	xx
Stern	SbSgMsAstr
Stert	xx
Sterz	xx
Stete	xx
Stetl	xx
Steuer	SbSgNt	steuern	VbIn
Steurer	xx
Steven	SbSgMs
Stich	SbSgMs	stechen	VbInStrg
Stichel	SbSgMs	sticheln	VbIn
Stichler	SbSgMsPers	sticheln	VbIn
Stickel	xx
Sticker	SbSgMs	sticken	VbIn
Stiefel	SbSgMs	stiefeln	VbIn
Stiege	SbSgFm	steigen	VbIn
Stiel	SbSgMs
Stiesel	xx
Stift	SbSgMs
Stifter	SbSgMs	stiften	VbIn
Stil	SbSgMs
Stilb	xx
Stimmchen	SbSgNtDimt	Stimme	SbSgFm
Stimme	SbSgFm
Stimmer	xx
Stinker	SbSgMs	stinken	VbIn
Stint	xx
Stipp	SbSgMs
Stippe	SbSgFm
Stirn	SbSgFm
Stirne	SbSgFm
Stober:	xx
Stocher	SbSgMs	stochern	VbIn
Stock	SbSgMs
Stockchen:	SbSgNtDimt	Stock	SbSgMs
Stockel:	xx
Stockl:	xx
Stoff	SbSgMsClth
Stoffel	SbSgMs
Stolle	SbSgFm
Stollen	SbSgMs
Stolze	SbSgMsPers
Stop	SbSgMsForg.En
Stopfer	SbSgMs	stopfen	VbIn
Stopp	SbSgMsForg.En
Stoppel	SbSgMs	stoppeln	VbIn
Stopper	SbSgMsForg	stoppen	VbIn
Stopsel:	SbSgMs
Stor:	SbSgMsZool
Storch	SbSgMsZool
Store	xx
Storen	xx
Storer:	SbSgMsPers	storen:	VbIn
Storger	xx
Storm	NmSurn
Stotz	xx
Stotzen	xx
Stovchen	xx
Stovchen:	SbSgNtDimt
Stove	xx
Stoß	SbSgMs	stoßen	VbIn
Stoßchen:	SbSgNtDimt	Stoß	SbSgMs
Stoßel:	SbSgMs
Stoßer:	xx
Straddle	SbSgFmForg
Strafe	SbSgFm	strafen	VbIn
Strahl	SbSgMs	strahlen	VbIn
Strahler	SbSgMs	strahlen	VbIn
Strahler:	xx
Strahn:	xx
Strahne:	SbSgFm
Strak	xx
Strampler	SbSgMs	strampeln	VbIn
Strand	SbSgMs
Strang	SbSgMs
Strange	xx
Straps	SbSgMs
Strass	SbSgMs
Straube	xx
Strauch	SbSgMs
Straus	xx
Strauß	SbSgMs
Straußchen:	SbSgNtDimt	Strauß	SbSgMs
Strazze	xx
Straßchen:	SbSgNtDimt	Straße	SbSgFm
Straße	SbSgFm
Streb	xx
Strebe	SbSgFm
Streber	SbSgMs	streben	VbIn
Strecke	SbSgFm
Strecker	SbSgMs	strecken	VbIn
Strehler	xx
Streich	SbSgMs
Streiche	SbPl	Streich
Streicher	SbSgMs	streichen	VbIn
Streif	SbSgMs	streifen	VbIn
Streife	SbSgFm	streifen	VbIn
Streifen	SbSgMs	streifen	VbIn
Streik	SbSgMs	streiken	VbIn
Streit	SbSgMs	streiten	VbInStrg
Streiter	SbSgMs	streiten	VbIn
Stremel	xx
Strenge	SbSgFm	streng	Aj
Stress	SbSgMsForg.En
Stretch	SbSgMsClthForg.En
Streu	SbSgFm
Streue	xx
Streuer	SbSgMs	streuen	VbIn
Streuner	SbSgMsPers	streunen	VbIn
Streusel	SbSgMsNutr
Strich	SbSgMs
Stricher	SbSgMsPers
Strick	xx
Stricker	SbSgMsPers	stricken	VbIn
Striegel	SbSgMs	striegeln	VbIn
Strieme	SbSgFm
Striemen	SbPl
Striezel	SbSgMs
Strike	SbSgMsForg.En
String	SbSgMsForg.En
Strip	SbSgMsForg.En
Strippe	SbSgFm
Stripper	SbSgMsProfForg	strippen	VbIn
Stritt	xx
Strobel	NmSurn
Stroh	SbSgNt
Strolch	SbSgMsPers
Strom	SbSgMs
Stromer	SbSgMsPers
Strophe	SbSgFmMusi
Stropp	xx
Strosse	xx
Strotter	xx
Strudel	SbSgMs	strudeln	VbIn
Strumpf	SbSgMs
Strumpfchen:	SbSgNtDimt	Strumpf	SbSgMs
Strunk	SbSgMs
Strunkchen:	SbSgNtDimt	Strunk	SbSgMs
Stubben	xx
Stubchen:	SbSgNtDimt	Stube	SbSgFm
Stube	SbSgFm
Stuber:	xx
Stuck	SbSgMs
Stuck:	SbSgNt
Stuckchen:	SbSgNtDimt
Stufe	SbSgFm
Stuhl	SbSgMs
Stuhlchen:	SbSgNtDimt	Stuhl	SbSgMs
Stulle	SbSgFm
Stulpe	SbSgFm
Stumme	xx
Stummel	SbSgMs
Stumpe	xx
Stumpen	SbSgMs
Stumper:	SbSgMsPers
Stumpfchen:	SbSgNtDimt	Stumpf	SbSgMs
Stundchen:	SbSgNtDimt	Stunde	SbSgFm
Stunde	SbSgFm
Stunk	SbSgMs	stinken	VbIn
Stunt	SbSgMsProfForg.En
Stupf	SbSgMs	stupfen	VbIn
Stupfer	SbSgMs	stupfen	VbIn
Stups	SbSgMs	stupsen	VbIn
Sturm	SbSgMsMeto
Sturmer:	SbSgMsProf	sturmen:	VbIn
Sturz	SbSg
Sturze:	SbPl	Sturz	SbSg
Sturzel	xx
Sturzel:	xxDiar
Stuss	SbSgMs
Stute	SbSgFmZool
Stuten	SbPlZool	Stute	SbSgFmZool
Stutz	SbSgMsCurr
Stutz:	xx
Stutze:	SbSgFm
Stutzer	SbSgMs	stutzen	VbIn
Suche	SbSgFm	suchen	VbIn
Sucher	SbSgMs	suchen	VbIn
Sucht	SbSgFm
Sucre	SbSgMsForg.Fr
Sud	SbSgMs
Sud:	SbSg
Sudel	SbSgMs
Suden:	SbSgMs
Sudler	SbSgMsPers
Sues	xx
Sueve	xx
Suez	NmGeogCityForg.Eg
Suff	SbSgMs	saufen	VbInStrg
Suffel:	xx
Suffler:	SbSgMsPers
Suhl	xx
Suhle	SbSgFm
Suhne:	SbSgFm	suhnen:	VbIn
Sull:	xx
Sulz	SbSgNt
Sulze	xx
Sulze:	SbSgFmNutr
Sumer	NmGeogCityForg.Ik
Summchen:	SbSgNtDimt	Summe	SbSgFm
Summe	SbSgFm
Summer	SbSgMs	summen	VbIn
Sumper	xx
Sumpf	SbSgMs
Sums	SbSgMsVulg
Sund	SbSgMs
Sunde:	SbSgFm
Sunder:	SbSgMsPers
Suntel:	xx
Suppchen:	SbSgNtDimtNutr	Suppe	SbSgFmNutr
Suppe	SbSgFmNutr
Sur	xx
Sure	SbSgFm
Surfer	SbSgMs	surfen	VbIn
Suse	NmFmPrenAbbr	Susanne	NmFmPren
Sust	xx
Susten	NmGeogMontForg.Ch
Suße:	SbSgFm	suß:	Aj
Swap	SbSgMsForg.En
Swebe	xx
Swift	xx
Swine	xx
Swing	SbSgMsForg.En
Swinger	SbSgMsPersForg.En	swingen	VbIn
Swiss	SbSgFmForg.Ch
Szekler	xx
Szene	SbSgFm
Szepter	SbSgNt
Ta	xx
Tab	xx
Tacker	SbSgMs
Tacks:	xx
Tadel	SbSgMs	tadeln	VbIn
Tadler	xx
Tael	xx
Tafel	SbSgFm	tafeln	VbIn
Tafer:	xx
Taft	SbSgMsClth
Tag	SbSgMs
Tai	xx
Taille	SbSgFmForg
Taine	xx
Take	xx
Takel	SbSgMs
Takler	xx
Taks:	xx
Takt	SbSgMs
Tal	SbSgNt
Talchen:	SbSgNtDimt	Tal	SbSgNt
Taler	SbSgMs
Talg	SbSgMs
Talje	xx
Talk	SbSgMsForg.En
Talker	xx
Tamp	xx
Tampen	SbSgMs
Tand	SbSgMs
Tandler	SbSgMs
Tandler:	xx
Tang	SbSgMs
Tanger	NmGeogCityForg.Mo
Tank	SbSgMs
Tanke	xx
Tanker	SbSgMs	tanken	VbIn
Tann	SbSgMs
Tannchen:	SbSgNtDimt	Tann	SbSgMs
Tanne	SbSgFmBota
Tanse	xx
Tantchen	SbSgNtDimtPers	Tante	SbSgFmPers
Tante	SbSgFmPers
Tanz	SbSgMs
Tanzchen:	SbSgNtDimt	Tanz	SbSgMs
Tanzer:	SbSgMsPers	Tanz	SbSgMs
Tape	SbSgNtForg.En
Tapfe	xx
Tapfen	xx
Tapp	xx
Taps	SbSgMsVulg
Taren	xx
Tarser	xx
Tartsche	SbSgFm
Taschchen:	SbSgNtDimt	Tasche	SbSgFm
Tasche	SbSgFm
Taschner	xx
Taschner:	SbSgMsProf
Tasschen:	SbSgNtDimt	Tasse	SbSgFm
Tasse	SbSgFm
Taste	SbSgFm	tasten	VbIn
Taster	SbSgMs	tasten	VbIn
Tat	SbSgFm
Tater:	SbSgMsPers	Tat	SbSgFm
Tatsch:	xx
Tatsche	xx
Tatzchen:	SbSgNtDimt	Tatze	SbSgFm
Tatze	SbSgFm
Tau	SbSgNt
Taubchen:	SbSgNtDimtZool	Taube	SbSgFmZool
Taube	SbSgFmZool
Tauber	NmGeogFlum.De
Tauber:	xx
Taucher	SbSgMs	tauchen	VbIn
Taufe	SbSgFm	taufen	VbIn
Taufer:	SbSgMsPers	taufen	VbIn
Taumel	SbSgMs	taumeln	VbIn
Tausch	SbSgMs
Tauscher:	xx
Taxe	SbSgFm	Taxi	SbSgFm
Taxler	SbSgMsProfVulg
Teckel	xx
Tee	SbSgMsNutr
Teen	SbSgMsPers
Teer	SbSgMs
Tegel	NmGeogCity.De
Teich	SbSgMs
Teil	SbSgNt
Teilchen	SbSgNtDimt	Teil	SbSgNt
Teiler	SbSgMs	teilen	VbIn
Tein	xx
Teint	SbSgMsForg.Fr
Teiste	xx
Tell	NmSurn
Teller	SbSgMs
Tempel	SbSgMs
Templer	SbSgMsProf
Tender	SbSgMs
Tenn	xx
Tenne	SbSgFm
Tepp	xx
Term	SbSgMsForg.Lt
Terme	SbSgFmForg.Lt
Terne	xx
Terpen	xx
Terz	SbSgFmMusi
Terzel	xx
Test	SbSgMsForg.En
Tester	SbSgMs	testen	VbIn
Tete	xx
Tetzel	NmSurn
Teuchel	xx
Teufe	SbSgFm
Teufel	SbSgMs
Text	SbSgMs
Texter	SbSgMs	texten	VbIn
Thai	SbSgMsPersCtry.Th	Thailand	NmGeogCtry.Th
Thailand	NmGeogCtry.Th
Thais	xx
Thale	xx
Thatcher	NmSurnForg.En
Theben	NmGeogCityForg.Gr
Thein	xx
Theist	xx
Theiß	xx
Theke	SbSgFmForg
Themse	SbSgFmFlumForg.En
Therme	SbSgFm
Thermen	SbPl	Therme	SbSgFm
These	SbSgFmForg.Gr
Thing	SbSgMs
Thon	xx
Thor	NmMsPren
Thorn	SbSgMsLetrForg.Is
Thorsten	NmMsPren
Thot	xx
Thoth	xx
Thraker	SbSgMsPersGeogRegnForg.Gr
Thrill	SbSgMsForg.En
Thriller	SbSgMsForg
Thrips	xx
Thron	SbSgMs
Thuje	xx
Thule	NmGeogRegnForg
Thun	NmGeogCityForg.Ch
Thur	NmGeogCityForg.Ch
Ti	xx
Tiber	NmGeogFlumForg.It
Tic	xx
Tick	SbSgMs
Ticker	SbSgMs	ticken	VbIn
Tide	SbSgFm
Tiden	SbPl	Tide	SbSgFm
Tieck	NmSurn
Tiefe	SbSgFm	tief	Aj
Tiegel	SbSgMs
Tier	SbSgNt
Tiger	SbSgMsZool
Tight	xx
Tilde	SbSgFmLetr
Till	NmPren
Tim	NmMsPren
Timbre	SbSgNtForg.Fr
Timer	SbSgMsForg.En
Timm	NmMsPren
Tine	NmPrenAbbr
Tinte	SbSgFm
Tip	SbSgMs
Tipp	SbSgMs
Tippel	xx
Tipper	SbSgMs	tippen	VbIn
Tippse	SbSgFmPersVulg
Tisch	SbSgMs
Tischler	SbSgMsProf
Titel	SbSgMs	titeln	VbIn
Titer	SbSgMsChem
Titre	xx
Titte	SbSgFmVulgBody
Tjalk	xx
Tjost	xx
To:	xx
Tobel	xx
Tochter	SbSgFmPers
Tod	SbSgMs
Toffel	xx
Toffel:	xxDiar
Token	SbSgMsForg.En
Tole:	xx
Tolle	SbSgFm
Tolpel:	SbSgMsPers
Tolt:	xx
Tomsk	xx
Ton	SbSgMs
Toner	SbSgMsForg.En
Tonnchen:	SbSgNtDimt	Tonne	SbSgFm
Tonne	SbSgFm
Topf	SbSgMs
Topfchen:	SbSgNtDimt	Topf	SbSgMs
Topfer:	SbSgMsProf	Topf	SbSgMs
Topp	Rp
Topten	xx
Tor	SbSgNt
Torf	SbSgMsBota
Torkel	SbSgMs	torkeln	VbIn
Torl:	xx
Torn:	SbSgMs
Torr	xx
Torsten	NmMsPren
Tort	SbSgMs
Tortchen:	SbSgNtDimtNutr	Torte	SbSgFmNutr
Torte	SbSgFmNutr
Tote	SbSgMsPers
Tower	SbSgMsForg.En
Trab	SbSgMs
Traber	SbSgMs	traben	VbIn
Tracht	SbSgFm
Trachtler	SbSgMs
Track	SbSgMsForg.En
Trader	SbSgMsPersForg.En
Traft	xx
Trage	SbSgFm	tragen	VbInStrg
Trager:	SbSgMsPers
Trail	SbSgMsForg.Us
Trailer	SbSgMsForg
Train	SbSgMsForg.En
Trainer	SbSgMsProfForg.En
Trakl	NmSurn
Trakt	SbSgMs
Tralje	xx
Tram	SbSgFmForg
Tramel:	xx
Tramen	xx
Tramp	SbSgMsForg.Us
Trampel	SbSgMs	trampeln	VbIn
Tramper	SbSgMs	trampen	VbIn
Tran	SbSgMsNutr
Trance	SbSgFmForg.Fr
Tranche	SbSgFmForg.Fr
Tranchen:	SbSgFmDimt	Trane:	SbSgFm
Trane:	SbSgFm
Trank	SbSgMs
Trankchen:	SbSgNtDimt	Trank	SbSgMs
Tranke:	SbSgFm
Transe	SbSgFm
Transfer	SbSgMsForg
Trap	xx
Trapp	xx
Trappe	xx
Trapper	SbSgMsPers
Trash	SbSgMsForg.En
Trass	xx
Trasse	SbSgFm
Tratsch	SbSgMs	tratschen	VbIn
Tratte	SbSgFm
Traubchen:	SbSgNtDimtNutr	Traube	SbSgFmNutr
Traube	SbSgFmNutr
Traudchen	NmFmPrenDimt	Traude	NmFmPren
Traude	NmFmPren
Traudel	NmFmPrenDimt
Trauer	SbSgFm	trauen	VbIn
Traufe	SbSgFm
Traum	SbSgMs
Traumen	xx
Traumen:	SbPlAc	Traum	SbSgMs
Traumer:	SbSgMsPers	Traum	SbSgMs
Traun	xx
Trauner	xx
Trautchen	NmFmPrenDimt	Traute	NmFmPren
Traute	NmFmPren
Trawl	xx
Trawler	SbSgMsForg
Trax	xx
Trebe	xx
Treber	xx
Treck	SbSgMsForg.Us
Trecker	SbSgMs	trecken	VbIn
Treff	SbSgMs	treffen	VbInStrg
Treffer	SbSgMs	treffen	VbIn
Treiber	SbSgMs	treiben	VbIn
Treidel	SbSgMs	treideln	VbIn
Treidler	SbSgMs
Tremse	xx
Trend	SbSgMsForg.En
Trense	SbSgFm
Treppchen	SbSgNtDimt	Treppe	SbSgFm
Treppe	SbSgFm
Tresen	SbSgMs
Trespe	xx
Tresse	xx
Trester	SbSgMsNutr
Treter	SbSgMs	treten	VbIn
Treue	SbSgFm	treu	Aj
Trichter	SbSgMs
Trick	SbSgMsForg.En
Trickser	SbSgMs	tricksen	VbIn
Trieb	SbSgMs	treiben	VbInStrg
Triel	xx
Trieler	SbSgMs	trielen	VbIn
Trient	NmGeogCityForg.It
Trier	NmGeogCity.De
Triere	xx
Trierer	SbSgMsGeogCity	Trier	NmGeogCity
Triest	NmGeogCityForg.It
Triester	SbSgMsPersGeogCityForg.It	Triest	NmGeogCityForg.It
Trifle	SbSgMsNutrForg.En
Trift	xx
Triller	SbSgMsMusi
Trimm	xx
Trimmer	SbSgMs	trimmen	VbIn
Trine	NmFmPrenAbbr
Trinker	SbSgMs	trinken	VbIn
Trip	SbSgMsForg.En
Tripel	SbSgNtForg.Lt
Tripper	SbSgMsMedc
Triste	SbSgFmForg.Fr
Tritt	SbSgMs	treten	VbInStrg
Trockne:	xx
Trockner	SbSgMs	trocknen	VbIn
Troddel	xx
Trodel:	SbSgMs
Trodler:	SbSgMsPers	Trodel:	SbSgMs
Troer	xx
Trog	SbSgMs
Troll	SbSgMsPers
Trombe	xx
Trommel	SbSgMs	trommeln	VbIn
Trommler	SbSgMs
Trope	xx
Tropen	SbPl
Tropf	SbSgMs
Tropfchen:	SbSgNtDimt	Tropf	SbSgMs
Tross	SbSgMs
Trosse	SbSgFm
Trost	SbSgMs
Troster:	SbSgMsPers	Trost	SbSgMs
Trote:	SbSgFm
Trott	SbSgMs
Trotte	SbSgFm
Trottel	SbSgMs
Trotzer	SbSgMs	trotzen	VbIn
Trub	xx
Trubel	SbSgMs
Truck	SbSgMsForg.En
Trucker	SbSgMsPersForg.En	Truck	SbSgMsForg.En
Trudchen	NmFmPrenDimt	Trude	NmFmPren
Trude	NmFmPren
Truffel:	SbSgMs
Trug	SbSgMs	trugen:	VbInStrg
Truhe	SbSgFm
Trum	xx
Trumm	SbSgNtDial
Trummer:	SbPl	Trumm	SbSgMs
Trumpf	SbSgMs
Trunk	SbSgMs	trinken	VbIn
Trupp	SbSgMsMilt
Truppchen:	SbSgNtDimtMilt	Trupp	SbSgMsMilt
Truppe	SbSgFmMilt
Trusche:	xx
Trust	SbSgMsForg.Us
Trute	xx
Trutz	SbSgMs
Tschad	NmGeogCtry
Tschader	SbSgMsPersGeogCtry	Tschad	NmGeogCtry
Tscheche	SbSgMsPersGeogCtry.Cz
Tschick	xx
Tschuktsche	xx
Tschurtschen	xx
Tschusch	xx
Tube	SbSgFm
Tuben	SbPl	Tube	SbSgFm
Tuch	SbSgNt
Tucke:	SbSgFm
Tuder:	xx
Tuff	SbSgMs
Tuftler:	xx
Tull:	SbSgMsClth
Tulle:	SbSgFm
Tulpe	SbSgFmBota
Tumbler	xx
Tummel	xx
Tummler	xx
Tummler:	SbSgMsZool
Tumpel:	SbSgMs
Tunche:	SbSgFm
Tuncher:	SbSgFmProf	Tunche:	SbSgFm
Tuner	SbSgMsForg	tunen	VbIn
Tunke	SbSgFm	tunken	VbIn
Tunnel	SbSgMs	tunneln	VbIn
Tunte	SbSgFmPersVulg
Tupf	SbSgMs	tupfen	VbIn
Tupfelchen:	SbSgNtDimt
Tupfer	SbSgMs	tupfen	VbIn
Tur:	SbSgFm
Turchen:	SbSgFm	Tur:	SbSgFm
Ture:	SbSgFm
Turf	SbSgMs
Turke:	SbSgMsPersGeogCtry.Tr	Turkei:	NmGeogCtry.Tr
Turm	SbSgMs
Turmchen:	SbSgNtDimt	Turm	SbSgMs
Turmer:	SbSgMsPers	Turm	SbSgMs
Turn	SbSgMsForg.En
Turner	SbSgMs	turnen	VbIn
Tusch	SbSgMs
Tusche	SbSgFm
Tusse	xx
Tutchen:	SbSgNtDimt	Tute:	SbSgFm
Tute:	SbSgFm
Tutel	xx
Tuttel:	SbSgMs
Twain	NmSurnForg
Tweed	SbSgMsClthForg.En
Twenter	xx
Twiete	xx
Twill	xx
Twist	SbSgMsForg.En
Ud	xx
Uecker	NmSurn
Uelzen	NmGeogCity.De
Uelzer	SbSgMsGeogCity.De	Uelzen	NmGeogCity.De
Ufer	SbSgNt
Uhr	SbSgFm
Uhrchen:	SbSgNtDimt	Uhr	SbSgFm
Ul	xx
Ulk	SbSgMs
Ulk:	xx
Ulm	NmGeogCity.De
Ulme	SbSgFmBota
Ulmer	SbSgMsGeogCity.De	Ulm	NmGeogCity.De
Ulster	NmGeogRegnForg.Ir
Umber	xx
Umbrer	SbSgMsPersGeogRegnForg.It	Umbrien	NmGeogRegnForg.It
Unke	SbSgFmZool
Unze	SbSgFmCurrForg.En
Ur	SbSgNtZool
Urd	xx
Urft	xx
Urne	SbSgFm
Urner	SbSgMsPersGeogRegnForg.Ch	Uri	NmGeogRegnForg.Ch
Urs	NmMsPren	
Urschel	xx
Ursel	NmFmPrenDimt
Ursner	xx
User	SbSgMsForg.En
Ute	NmFmPren
Utz	xx
Uwe	NmMsPren
Uz	xx
Vamp	SbSgMsPers
Varel	NmGeogCity.De
Vaschen:	SbSgNtDimt	Vase	SbSgFm
Vase	SbSgFm
Vater	SbSgMsPers
Vaud	NmGeogRegnForg.Ch
Vechte	xx
Veil	xx
Veilchen	SbSgNtDimtBota
Veit	NmSurn
Velpel	xx
Vene	xx
Venn	xx
Venner	xx
Verb	SbSgNtForg.Lt
Verden	xx
Verdruss	SbSgMs	verdrießen	VbIn
Verlust	SbSgMs	verlieren	VbIn
Vers	SbSgMsMusi
Verschliss	SbSgMs	verschleißen	VbIn
Verstand	SbSgMs	verstehen	VbIn
Verve	SbSgFmForg.Fr
Vesper	SbSgNtNutr
Veste	xx
Vettel	SbSgFm
Vetter	SbSgMsPers
Viech	SbSgNtDial	Vieh	SbSgNtZool
Vieh	SbSgNtZool
Vierer	SbSgMsNumr
Viper	SbSgFmZool
Viren	SbPlMedc	Virus	SbSgNtMedc
Visen	xx
Vize	SbSgMsTitl
Vlame	xx
Vlies	SbSgNtClthForg
Vogel	SbSgMsZool
Vogler	SbSgMsProf
Vogt	SbSgMsProf
Volk	SbSgNt
Volkchen:	SbSgNtDimt	Volk	SbSgNt
Volker	NmMsPren
Volsker	xx
Volt	SbSgNtMeas
Volte	SbSgFmForg.Lt
Voten	SbPl	Votum	SbSgNtForg.Lt
Voß	NmSurn
Waadt	NmGeogRegnForg.Ch
Waag	xx
Waage	SbSgFm	wiegen	VbInStrg
Waal	xx
Wabe	SbSgFm
Wache	SbSgFm	wachen	VbIn
Wachler	xx
Wachs	SbSgNt
Wacht	SbSgFm
Wachte:	SbSgFm
Wachtel	SbSgFmZool
Wachter:	SbSgMsPers	Wacht	SbSgFm
Wacke	xx
Wad	xx
Wade	SbSgFmBody
Wadl	SbSgNtBodyDialDimt	Wade	SbSgFmBody
Wafer	SbSgMsForg.En
Waffe	SbSgFmMilt
Waffel	SbSgFmNutr
Wagner	SbSgMsProf
Wahe:	SbSgFmNutr
Wahl	SbSgFm
Wahler:	SbSgMsPers	Wahl	SbSgFm
Wahn	SbSgMs
Waid	SbSgFm
Waise	SbSgMsPers
Wake	xx
Wal	SbSgMsZool
Wald	SbSgMsBota
Waldchen:	SbSgNtDimt	Wald	SbSgMs
Walke	xx
Walker	SbSgMsForg.En	walken	VbIn
Wall	SbSgMs
Waller	NmSurn
Walm	SbSgFm
Walser	NmSurn
Walter	NmMsPren
Walther	NmMsPren
Walze	SbSgFm
Walzer	SbSgMs
Walzer:	SbSgMsDiar	walzen:	VbIn
Wamme	xx
Wampe	SbSgFmVulg
Wams	SbSgNt
Wamschen:	SbSgNtDimt	Wams	SbSgNt
Wandel	SbSgMs	wandeln	VbIn
Wandler	SbSgMs
Wandrer	SbSgMsPersShor	Wanderer	SbSgMsPers
Wane	xx
Wange	SbSgFmBody
Wank	xx
Wankel	NmSurn
Wannchen:	SbSgNtDimt	Wanne	SbSgFm
Wanne	SbSgFm
Wanst	SbSgMsBodyVulg
Wanstchen:	SbSgNtDimtBodyVulg	Wanst	SbSgMsBodyVulg
Want	SbSgNt
Wanze	SbSgFmZool
Wappen	SbSgNt
Ware	SbSgFm
Warf	xx
Warft	xx
Warme:	SbSgFm	warm	Aj
Warndt	xx
Warner	SbSgMs	warnen	VbIn
Warp	SbSgMsForg.En
Warte	SbSgFm	warten	VbInStrg
Warter:	SbSgMsProf	warten	VbIn
Warthe	xx
Warzchen:	SbSgNtDimtBody	Warze	SbSgFmBody
Warze	SbSgFmBody
Wasche:	SbSgFm	waschen	VbIn
Wasen	SbSgMs
Wasser	SbSgNt
Watsche	SbSgFmVulg
Watt	SbSgNtMeas
Watte	SbSgFm
Watten	SbPl
Web	SbSgNtForg.En
Webe	xx
Weber	SbSgMs	weben	VbIn
Wechsel	SbSgMs	wechseln	VbIn
Wechsler	SbSgMs
Wechte	xx
Weck	xx
Wecke	xx
Wecker	SbSgMs	wecken	VbIn
Wedel	SbSgMs	wedeln	VbIn
Weden	xx
Weft	xx
Weg	SbSgMs
Weger	xx
Weggen	xx
Wehl	xx
Wehle	xx
Wehr	SbSgNt
Weib	SbSgNtPers
Weibchen	SbSgNtDimtPers	Weib	SbSgNtPers
Weibel	NmSurn
Weibsen	SbPlVulg	Weib	SbSgNtPers
Weiche	SbSgFm
Weichsel	SbSgMs
Weide	SbSgFm	weiden	VbIn
Weife	xx
Weih	xx
Weihe	SbSgFm
Weiher	SbSgMs	weihen	VbIn
Weilchen	SbSgNtDimt	Weile	SbSgFm
Weile	SbSgFm
Weiler	SbSgMs	weilen	VbIn
Wein	SbSgMsNutr
Weise	SbSgFm	weisen	VbInStrg
Weisel	xx
Weiser	SbSgMs	weisen	VbIn
Weite	SbSgFm	weit	Aj
Weizen	SbSgMsNutr
Weiße	SbSgFm
Welf	xx
Welfe	SbSgMsPers
Welle	SbSgFm
Weller	NmSurn
Welpe	SbSgMsZool
Wels	SbSgMsZool
Welsche	xx
Welt	SbSgFm
Wencke	NmSurn
Wende	SbSgFm	wenden	VbInStrg
Wendel	SbSgFm
Wenzel	NmMsPren
Werber	SbSgMs	werben	VbIn
Werder	SbSgMs	werden	VbIn
Werfel	xx
Werfer	SbSgMs	werfen	VbIn
Werft	SbSgFm
Werg	SbSgNt
Werk	SbSgNt
Werkel	xx
Werner	NmMsPren
Werre	xx
Werst	xx
Werther	NmSurn
Wesel	xx
Weser	NmFmGeogFlum
Wespe	SbSgFmZool
West	SbSgNt
Weste	SbSgFm
Westen	SbSgMs
Westler	SbSgMs
Wette	SbSgFm	wetten	VbIn
Wetter	SbSgNtMeto
Whig	xx
Whist	xx
Wibke	NmFmPren
Wichs	SbSgNt
Wichse	SbSgFm
Wichser	SbSgMs	wichsen	VbIn
Wicht	SbSgMsPers
Wichte	SbPl	Wicht	SbSgMsPers
Wichtel	SbSgMsDimt	Wicht	SbSgMs
Wicke	SbSgFmBota
Wickel	SbSgMs	wickeln	VbIn
Wickler	SbSgMs
Widder	SbSgMsZool
Wiebke	NmFmPren
Wied	xx
Wiede	xx
Wiege	SbSgFm	
Wiek	xx
Wien	NmGeogCityForg.At
Wiener	SbSgMsGeogCityForg.At	Wien	NmGeogCityForg.At
Wiepe	xx
Wiese	SbSgFm
Wiesel	SbSgNt	wieseln	VbIn
Wight	xx
Wilde	SbSgMsPers
Will	xx
Wille	SbSgMs
Wilm	xx
Wilster	xx
Wim	NmMsPren
Wimmer	xx
Wimpel	SbSgMs
Wimper	SbSgFmBody
Wind	SbSgMsMeto
Winde	SbSgFm	winden	VbInStrg
Windel	SbSgFm	windeln	VbIn
Wink	SbSgMs	winken	VbIn
Winkel	SbSgMs	winkeln	VbIn
Winker	SbSgMs	winken	VbIn
Winsch	SbSgFm
Winter	SbSgMsTime
Winzer	SbSgMsProf
Wipfel	SbSgMs
Wippe	SbSgFm	wippen	VbIn
Wipper	xx
Wirbel	SbSgMs	wirbeln	VbIn
Wirker	xx
Wirren	SbPl	Wirre	SbSgFm
Wirt	SbSgMsProf
Wirtel	xx
Wirz	xx
Wisch	SbSgMs
Wischer	SbSgMs	wischen	VbIn
Witwe	SbSgFmPers
Witwer	SbSgMsPers	Witwe	SbSgFmPers
Witz	SbSgMs
Woche	SbSgFm
Wocken	xx
Woge	SbSgFm	wogen	VbIn
Wohrde:	xx
Wok	SbSgMsForg
Wolf	SbSgMsZool
Wolfchen:	SbSgNtDimtZool	Wolf	SbSgMsZool
Wolkchen:	SbSgNtDimtMeto	Wolke	SbSgFmMeto
Wolke	SbSgFmMeto
Wolle	SbSgFm
Won	xx
Wonne	SbSgFm
Worb	xx
Worbe	xx
Worgl:	NmGeogCityForg.At
Worms	NmGeogCity.De
Wormser	SbSgMsNmGeogCity.De	Worms	NmGeogCity.De
Wort	SbSgNt
Wortchen:	SbSgNtDimt	Wort	SbSgNt
Wrap	SbSgMsNutrForg.En
Wrasen	xx
Wruke	xx
Wucher	SbSgMs
Wuchs	SbSgMs	wachsen	VbInStrg
Wucht	SbSgFm
Wuhler:	SbSgMs
Wuhne	xx
Wuhr	xx
Wulst	SbSgMs
Wulstchen:	SbSgNtDimt	Wulst	SbSgMs
Wunde	SbSgFm
Wunder	SbSgNt
Wune	xx
Wunsch	SbSgMs	wunschen:	VbIn
Wupper	NmGeogFlum.De
Wurde:	SbSgFm
Wurf	SbSgMs
Wurfchen:	SbSgNtDimt	Wurf	SbSgMs
Wurfel:	SbSgMs
Wurger:	SbSgMsPers
Wurm	SbSgMsZool
Wurmchen:	SbSgNtDimtZool	Wurm	SbSgMsZool
Wurst	SbSgFmNutr
Wurstchen:	SbSgNtDimtNutr	Wurst	SbSgFmNutr
Wurstel	SbSgMsDimtVulg
Wurstel:	SbSgNtDimtNutrVulg	Wurst	SbSgFmNutr
Wurster	SbSgMs
Wurstler	xx
Wurt	xx
Wurte	xx
Wurz	SbSgMs
Wurze:	SbSgFm
Wurzel	SbSgMs	wurzeln	VbIn
Wust	SbSgMs
Wuste:	SbSgFm
Wut	SbSgFm
Wuter:	SbSgMsPers	Wut	SbSgFm
Wutz	xx
Wuzler	xx
Xanten	NmGeogCity.De
Xanthen	xx
Xaver	NmMsPren
Xi	SbSgNtLetrForg.Gr
Zackchen:	SbSgNtDimt	Zacke	SbSgFm
Zacke	SbSgFm
Zagel	xx
Zahl	SbSgFm
Zahler	SbSgMs	zahlen	VbIn
Zahler:	SbSgMsDiar	zahlen:	VbIn
Zahn	SbSgMsBody
Zahnchen:	SbSgNtDimtBody	Zahn	SbSgMsBody
Zahre:	SbSgFm
Zahrte:	xx
Zain	xx
Zaine	xx
Zaire	NmGeogCtry.Za
Zairer	SbSgMsPersGeogCtry.Za	Zaire	NmGeogCtry.Za
Zander	SbSgMsZool
Zange	SbSgFm
Zank	SbSgMs
Zanker:	xx
Zapf	xx
Zapfchen:	SbSgNtDimt	Zapfen	SbSgMs
Zapfen	SbSgMs
Zapfer	SbSgMs	zapfen	VbIn
Zappler	SbSgMs	zappeln	VbIn
Zar	SbSgMsTitl
Zarge	SbSgFm
Zarte:	xx
Zasel	xx
Zaser	xx
Zaspel	xx
Zaster	SbSgMsVulg
Zauber	SbSgMs
Zaubrer	xx
Zauche	xx
Zaudrer	xx
Zaum	SbSgMs
Zaun	SbSgMs
Zaunchen:	SbSgNtDimt	Zaun	SbSgMs
Zaupe	xx
Zeche	SbSgFm	zechen	VbIn
Zecher	SbSgMs	zechen	VbIn
Zeck	SbSgMs
Zecke	SbSgFm	Zeck	SbSgMs
Zeder	SbSgFmBota
Zeese	xx
Zeh	SbSgMs
Zehe	SbSgFm	Zeh	SbSgMs
Zehner	SbSgMs
Zeichen	SbSgNt
Zeichner	SbSgMs	zeichnen	VbIn
Zeidler	xx
Zeiger	SbSgMs	zeigen	VbIn
Zeile	SbSgFm
Zeine	xx
Zeischen	xx
Zeit	SbSgFm
Zeitz	NmGeogCity.De
Zeitzer	SbSgMsPersGeogCity.De	Zeitz	NmGeogCity.De
Zeiß	xx
Zelge	xx
Zell	xx
Zelle	SbSgFm
Zeller	NmSurn
Zelt	SbSgNt
Zelte	SbPl	Zelt	SbSgNt
Zelter	SbSgMs	zelten	VbIn
Zeltler	xx
Zent	xx
Zentner	SbSgMs
Zepter	SbSgNt
Zerbst	xx
Zerbster	xx
Zeste	xx
Zeter	xx
Zett	xx
Zettel	SbSgMs
Zeug	SbSgNt
Zeuge	SbSgMsPers
Zeugs	SbSgNtVulg	Zeug	SbSgNt
Zeus	NmMsForg.Gr
Zeute	xx
Zibbe	xx
Zicke	SbSgFmPersVulg
Zickel	xx
Zider	xx
Zieche	xx
Ziefer	xx
Ziege	SbSgFmZool
Ziegel	SbSgMs	ziegeln	VbIn
Zieger	xx
Ziegler	NmSurn
Ziehe	xx
Ziel	SbSgNt
Ziem	xx
Ziemer	SbSgMs	ziemen	VbIn
Ziepchen	xx
Zier	SbSgFm	zieren	VbIn
Zierde	SbSgFm	zieren	VbIn
Ziesel	xx
Ziest	xx
Zieten	xx
Ziethen	xx
Ziffer	SbSgFm
Ziger	xx
Zille	NmSurn
Zimbel	SbSgNt
Zimber	xx
Zimmer	SbSgNt
Zimt	SbSgMsNutr
Zinder	xx
Zingel	xx
Zink	SbSgNtMetl
Zinke	SbSgFm
Zinker	SbSgMs	zinken	VbIn
Zinn	SbSgNtMetl
Zinne	SbSgFm
Zins	SbSgMs
Zipf	xx
Zipfel	SbSgMs
Zippe	xx
Zipper	xx
Zips	xx
Zipser	xx
Zirbe	xx
Zirbel	SbSgMs
Zirkel	SbSgMs	zirkeln	VbIn
Zirpe	xx
Zirren	xx
Ziste	xx
Zither	SbSgFmMusi
Zitwer	xx
Zitze	SbSgFmBody
Zmorge	xx
Zmorgen	xx
Znacht	xx
Zobel	SbSgMsZool
Zober	xx
Zocker	SbSgMs	zocken	VbIn
Zoe	NmFmPren
Zofe	SbSgFmProf
Zoff	SbSgMsVulg
Zohe	xx
Zoll	SbSgMs
Zollner:	xx
Zone	SbSgFm
Zopf	SbSgMsBody
Zopfchen:	SbSgNtDimtBody	Zopf	SbSgMsBody
Zorn	SbSgMs
Zosse	xx
Zossen	xx
Zoster	xx
Zote	SbSgFm
Zotte	xx
Zottel	SbSgMs	zotteln	VbIn
Zschokke	xx
Zuber	SbSgMs
Zuchen:	xx
Zucht	SbSgFm
Zuchter:	SbSgMsProf	Zucht	SbSgFm
Zuck	xx
Zucker	SbSgMsNutr
Zug	SbSgMs
Zugel:	SbSgMs	zugeln:	VbIn
Zuger	SbSgMsPersGeogCityForg.Ch
Zulp	xx
Zundel	xx
Zunder	SbSgMs
Zunder:	SbSgMsDiar
Zundler:	xx
Zunft	SbSgFm
Zunftler:	xx
Zunge	SbSgFmBody
Zunsler:	xx
Zurcher:	SbSgMsPersGeogCityForg.Ch	Zurich:	NmGeogCityForg.Ch
Zwang	SbSgMs	zwingen	VbInStrg
Zweck	SbSgMs
Zwecke	SbPl	Zweck	SbSgMs
Zwehle	xx
Zweier	SbSgMs
Zweifel	SbSgMs	zweifeln	VbIn
Zweifler	SbSgMs
Zweig	SbSgMs
Zwenke	xx
Zwerg	SbSgMsPers
Zwetsche	xx
Zwetschge	SbSgFmNutr
Zwetschke	xx
Zwicke	xx
Zwickel	SbSgMs
Zwicker	SbSgMs	zwicken	VbIn
Zwiebel	SbSgFm	zwiebeln	VbIn
Zwiesel	SbSgNt	zwieseln	VbIn
Zwilch	xx
Zwille	SbSgFm
Zwinge	SbSgFm	zwingen	VbIn
Zwinger	SbSgMs	zwingen	VbIn
Zwirn	SbSgMsClth
Zwist	SbSgMs
Zwitter	SbSgMsPers
Zwolfer:	SbSgMs
Zwolften:	xx
adeln	VbIn
angeln	VbIn
baden	VbIn
bammeln	VbIn
bannen	VbIn
bauen	VbIn
befleißen	VbInStrg
beizen	VbIn
beißen	VbIn
beißen	VbInStrg
beten	VbIn
betteln	VbIn
beugen	VbIn
beuteln	VbIn
biegen	VbInStrg
bieten	VbIn
bimmeln	VbIn
binden	VbIn
bitten	VbInStrg
blaffen	VbIn
blasen	VbInStrg
bleiben	VbInStrg
bleichen	VbInStrg
blenden	VbIn
blinken	VbIn
blochen	VbIn
blocken	VbIn
bluten	VbIn
bohren	VbIn
bomben	VbIn
boxen	VbIn
braten	VbInStrg
brauen	VbIn
brechen	VbIn
brechen	VbInStrg
bremsen	VbIn
brennen	VbIn
brennen	VbInStrg
bringen	VbIn
brummen	VbIn
buckeln	VbIn
buddeln	VbIn
buhlen	VbIn
bummeln	VbIn
campen	VbInForg
cutten	VbInForg
deckeln	VbIn
dengeln	VbIn
denken	VbIn
deuten	VbIn
dichten	VbIn
dienen	VbIn
dieseln	VbIn
docken	VbIn
doppeln	VbIn
drangen:	VbInStrg
drehen	VbIn
dreschen	VbIn
dreschen	VbInStrg
drosseln	VbIn
ducken	VbIn
dulden	VbIn
duseln	VbIn
essen	VbIn
fabeln	VbIn
fackeln	VbIn
fahnden	VbIn
fahren	VbIn
fallen	VbInStrg
falten	VbIn
falten	VbInStrg
falzen	VbIn
farben:	VbInStrg
fasen	VbIn
fechten	VbIn
fegen	VbIn
fehlen	VbIn
feien	VbIn
ferkeln	VbIn
fesseln	VbIn
fiedeln	VbIn
fighten	VbInForg
finden	VbIn
finden	VbInStrg
fischen	VbIn
fisteln	VbIn
fixen	VbIn
flechten	VbIn
flechten	VbInStrg
flegeln	VbIn
flicken	VbIn
fliegen	VbIn
fliegen	VbInStrg
fliehen	VbInStrg
fließen	VbInStrg
flitzen	VbIn
fluchen	VbIn
foppen	VbIn
formen	VbIn
forschen	VbIn
fragen	VbIn
freien	VbIn
fressen	VbIn
fressen	VbInStrg
frosten	VbIn
fuchteln	VbIn
fummeln	VbIn
funken	VbIn
fuseln	VbIn
fusseln	VbIn
gabeln	VbIn
gaffen	VbIn
gammeln	VbIn
gautschen	VbIn
geben	VbIn
geben	VbInStrg
gefallen	VbInStrg
gegnen	VbIn
gehen	VbIn
gehen	VbInStrg
geigen	VbIn
geißeln	VbIn
gerben	VbIn
gießen	VbIn
gießen	VbInStrg
gipfeln	VbIn
gipsen	VbIn
glasen	VbIn
gleiten	VbIn
golfen	VbIn
gondeln	VbIn
graben	VbInStrg
grabschen	VbIn
grapschen	VbIn
grasen	VbIn
graupeln	VbIn
greifen	VbIn
greifen	VbInStrg
grenzen	VbIn
gruseln	VbIn
gucken	VbIn
gurgeln	VbIn
hacken	VbIn
hageln	VbIn
halten	VbIn
halten	VbInStrg
handeln	VbIn
hanteln	VbIn
harzen	VbIn
haspeln	VbIn
hassen	VbIn
hauen	VbInStrg
hebeln	VbIn
heben	VbIn
heften	VbIn
hegen	VbIn
hehlen	VbIn
heilen	VbIn
heizen	VbIn
helfen	VbIn
helfen	VbInStrg
henken	VbIn
herrschen	VbIn
hetzen	VbIn
heulen	VbIn
hexen	VbIn
himmeln	VbIn
hobeln	VbIn
hopsen	VbIn
horchen	VbIn
japsen	VbIn
jauchzen	VbIn
jazzen	VbIn
jobben	VbIn
jodeln	VbIn
joggen	VbIn
jubeln	VbIn
juchzen	VbIn
jumpen	VbIn
kabeln	VbIn
kacheln	VbInStrg
kacken	VbIn
kandeln	VbIn
kapseln	VbIn
kegeln	VbIn
kennen	VbIn
kicken	VbIn
kieken	VbIn
kieseln	VbIn
kiffen	VbIn
killen	VbIn
kippen	VbIn
kitzeln	VbIn
klappen	VbIn
klatschen	VbIn
kleben	VbIn
klecksen	VbIn
klingeln	VbIn
klingen	VbInStrg
klinken	VbIn
klopfen	VbIn
knacken	VbIn
knebeln	VbIn
kneifen	VbIn
kneifen	VbInStrg
knicken	VbIn
knobeln	VbIn
knubbeln	VbIn
koken	VbIn
koksen	VbIn
koppeln	VbIn
krachen	VbIn
kraulen	VbIn
krauten	VbIn
kreiseln	VbIn
krempeln	VbIn
kreuzen	VbIn
kriechen	VbIn
kriegen	VbIn
kringeln	VbIn
kugeln	VbIn
kuppeln	VbIn
kurbeln	VbIn
kuscheln	VbIn
kussen:	VbInStrg
lachen	VbIn
laden	VbIn
laden	VbInStrg
lasten	VbIn
lauschen	VbIn
lausen	VbIn
lehren	VbIn
leiden	VbInStrg
leihen	VbInStrg
leiten	VbIn
lenken	VbIn
lesen	VbIn
leuchten	VbIn
leugnen	VbIn
lochen	VbIn
loggen	VbIn
loten	VbInStrg
lugen:	VbInStrg
lutschen	VbIn
machen	VbIn
mahlen	VbInStrg
mahnen	VbIn
makeln	VbIn
malen	VbIn
mangeln	VbIn
mehren	VbIn
meißeln	VbIn
melden	VbIn
melken	VbIn
melken	VbInStrg
mergeln	VbIn
merken	VbIn
messen	VbIn
messen	VbInStrg
mieten	VbIn
mischen	VbIn
misten	VbIn
mixen	VbIn
modeln	VbIn
mucksen	VbIn
muffeln	VbIn
murksen	VbIn
murmeln	VbIn
mussen:	VbInStrg
nadeln	VbIn
nageln	VbIn
nagen	VbIn
naschen	VbIn
nebeln	VbIn
neiden	VbIn
nennen	VbIn
neppen	VbIn
nesteln	VbIn
nicken	VbIn
nuckeln	VbIn
nudeln	VbIn
nutzen	VbIn
ordnen	VbIn
orgeln	VbIn
packen	VbIn
paddeln	VbIn
panschen	VbIn
parken	VbIn
patzen	VbIn
pauken	VbIn
peilen	VbIn
pendeln	VbIn
pennen	VbIn
petzen	VbIn
pfeifen	VbInStrg
pflanzen	VbIn
pflegen	VbIn
pflegen	VbInStrg
pfuschen	VbIn
pickeln	VbIn
piepsen	VbIn
piksen	VbIn
pinkeln	VbIn
pinseln	VbIn
popeln	VbIn
prahlen	VbIn
prallen	VbIn
prangen	VbIn
prassen	VbIn
preisen	VbInStrg
prellen	VbIn
puffen	VbIn
pupsen	VbIn
purzeln	VbIn
pushen	VbIn
putzen	VbIn
rappeln	VbIn
rasen	VbIn
raspeln	VbIn
rasseln	VbIn
rasten	VbIn
rauchen	VbIn
raufen	VbIn
raunzen	VbIn
rechnen	VbIn
regeln	VbIn
reihen	VbIn
reiten	VbIn
reiten	VbInStrg
reißen	VbInStrg
rennen	VbIn
retten	VbIn
reuten	VbIn
richten	VbIn
riechen	VbIn
riegeln	VbIn
riffeln	VbIn
ringen	VbIn
ringen	VbInStrg
rocken	VbIn
rodeln	VbIn
rollen	VbIn
rufen	VbIn
rummeln	VbIn
rumpeln	VbIn
runzeln	VbIn
sagen	VbIn
satteln	VbIn
saufen	VbInStrg
saugen	VbIn
saugen	VbInStrg
sausen	VbIn
scannen	VbIn
schaben	VbIn
schachteln	VbIn
schaffen	VbIn
schallen	VbInStrg
schalten	VbIn
schauen	VbIn
schaufeln	VbIn
schaukeln	VbIn
scheffeln	VbIn
scheiden	VbInStrg
scheinen	VbInStrg
scheiteln	VbIn
scheißen	VbIn
schelten	VbInStrg
scheuen	VbIn
schieben	VbIn
schiffen	VbIn
schimmeln	VbIn
schimpfen	VbIn
schindeln	VbIn
schinden	VbIn
schinden	VbInStrg
schlampen	VbIn
schlecken	VbIn
schleichen	VbIn
schleichen	VbInStrg
schleifen	VbIn
schleifen	VbInStrg
schleimen	VbIn
schleißen	VbInStrg
schlemmen	VbIn
schleppen	VbIn
schlichten	VbIn
schließen	VbIn
schließen	VbInStrg
schlingen	VbInStrg
schluchzen	VbIn
schlucken	VbIn
schlurfen	VbIn
schmeißen	VbInStrg
schmieren	VbIn
schmirgeln	VbIn
schmuddeln	VbIn
schmuggeln	VbIn
schmusen	VbIn
schnalzen	VbIn
schnappen	VbIn
schnarchen	VbIn
schnaufen	VbIn
schnauzen	VbIn
schneiden	VbIn
schnipfeln	VbIn
schnippeln	VbIn
schnipseln	VbIn
schnitzeln	VbIn
schnitzen	VbIn
schnorcheln	VbIn
schnorren	VbIn
schnupfen	VbIn
schocken	VbIn
schonen	VbIn
schrappen	VbIn
schrauben	VbIn
schrecken	VbInStrg
schreiben	VbIn
schreiben	VbInStrg
schreien	VbIn
schreien	VbInStrg
schreiten	VbInStrg
schrubben	VbIn
schummeln	VbIn
schwarz	AjColr
schwefeln	VbIn
schweigen	VbIn
schweißen	VbIn
schwelgen	VbIn
schwellen	VbIn
schwellen	VbInStrg
schwenken	VbIn
schwimmen	VbIn
schwimmen	VbInStrg
schwindeln	VbIn
schwinden	VbInStrg
schwingen	VbIn
schwingen	VbInStrg
schworen:	VbInStrg
segeln	VbIn
sehen	VbIn
seihen	VbIn
senden	VbIn
senken	VbIn
sennen	VbIn
setzen	VbIn
seufzen	VbIn
sicheln	VbIn
sieden	VbIn
siegeln	VbIn
siegen	VbIn
sinnen	VbInStrg
sitzen	VbInStrg
skaten	VbIn
spachteln	VbIn
spannen	VbIn
sparen	VbIn
speicheln	VbIn
spenden	VbIn
spicken	VbIn
spiegeln	VbIn
spießen	VbIn
spinnen	VbIn
spinnen	VbInStrg
spitzeln	VbIn
spitzen	VbIn
splitten	VbIn
sprechen	VbIn
sprechen	VbInStrg
sprenkeln	VbIn
springen	VbIn
springen	VbInStrg
sprinten	VbIn
spritzen	VbIn
sprudeln	VbIn
stacheln	VbIn
stampfen	VbIn
stapeln	VbIn
starten	VbIn
stauchen	VbIn
stauen	VbIn
stechen	VbIn
stechen	VbInStrg
stecken	VbIn
stecken	VbInStrg
stehen	VbIn
steigen	VbIn
steigen	VbInStrg
stellen	VbIn
stempeln	VbIn
steppen	VbIn
sticheln	VbIn
sticken	VbIn
stiefeln	VbIn
stiften	VbIn
stinken	VbIn
stopfen	VbIn
stoppeln	VbIn
stoppen	VbIn
stoßen	VbInStrg
streben	VbIn
strecken	VbIn
streichen	VbIn
streiten	VbIn
streiten	VbInStrg
streuen	VbIn
streunen	VbIn
stricken	VbIn
striegeln	VbIn
strippen	VbIn
strudeln	VbIn
stupfen	VbIn
stutzen	VbIn
suchen	VbIn
summen	VbIn
surfen	VbIn
swingen	VbIn
tadeln	VbIn
tafeln	VbIn
tanken	VbIn
tasten	VbIn
tauchen	VbIn
taumeln	VbIn
teilen	VbIn
testen	VbIn
texten	VbIn
ticken	VbIn
tippen	VbIn
titeln	VbIn
tonen	VbIn
torkeln	VbIn
traben	VbIn
tragen	VbInStrg
trampeln	VbIn
trampen	VbIn
trauen	VbIn
trecken	VbIn
treffen	VbIn
treffen	VbInStrg
treiben	VbIn
treiben	VbInStrg
treideln	VbIn
treten	VbIn
treten	VbInStrg
tricksen	VbIn
trielen	VbIn
trimmen	VbIn
trinken	VbIn
trocknen	VbIn
trommeln	VbIn
trotzen	VbIn
trugen:	VbInStrg
tun	VbInStrg
tunen	VbIn
tunneln	VbIn
tupfen	VbIn
turnen	VbIn
verderben	VbInStrg
vergessen	VbInStrg
wachsen	VbInStrg
wagen:	VbInStrg
walken	VbIn
wandeln	VbIn
warnen	VbIn
warten	VbInStrg
weben	VbIn
wechseln	VbIn
wecken	VbIn
wedeln	VbIn
weihen	VbIn
weilen	VbIn
weisen	VbIn
weisen	VbInStrg
wenden	VbInStrg
werben	VbIn
werden	VbIn
werfen	VbIn
werfen	VbInStrg
wetten	VbIn
wichsen	VbIn
wickeln	VbIn
wiegen	VbInStrg
wieseln	VbIn
windeln	VbIn
winden	VbInStrg
winkeln	VbIn
winken	VbIn
wippen	VbIn
wirbeln	VbIn
wischen	VbIn
wurzeln	VbIn
zahlen	VbIn
zahlen:	VbInDiar
zechen	VbIn
zeichnen	VbIn
zeigen	VbIn
zelten	VbIn
zetteln	VbIn
ziegeln	VbIn
ziemen	VbIn
zinken	VbIn
zirkeln	VbIn
zocken	VbIn
zotteln	VbIn
zweifeln	VbIn
zwicken	VbIn
zwiebeln	VbIn
zwieseln	VbIn
zwingen	VbIn
zwingen	VbInStrg
