Actinium	=SbSgNtChem.Ac
Aluminium	=SbSgNtChem.Al
Americium	=SbSgNtChem.Am
Antimon	=SbSgNtChem.Sb
Argon	=SbSgNtChem.Ar
Arsen	=SbSgNtChem.As
Astat	=SbSgNtChem.At
Barium	=SbSgNtChem.Ba
Berkelium	=SbSgNtChem.Bk
Beryllium	=SbSgNtChem.Be
Bismut	=SbSgNtChem.Bi
Blei	=SbSgNtChem.Pb
Bohrium	=SbSgNtChem.Bh
Bor	=SbSgNtChem.B
Brom	=SbSgNtChem.Br
Cadmium	=SbSgNtChem.Cd
Caesium	=SbSgNtChem.Cs
Calcium	=SbSgNtChem.Ca
Californium	=SbSgNtChem.Cf
Cer	=SbSgNtChem.Ce
Chlor	=SbSgNtChem.Cl
Chrom	=SbSgNtChem.Cr
Curium	=SbSgNtChem.Cm
Darmstadtium	=SbSgNtChem.Ds
Dubnium	=SbSgNtChem.Db
Dysprosium	=SbSgNtChem.Dy
Einsteinium	=SbSgNtChem.Es
Eisen	=SbSgNtChem.Fe
Erbium	=SbSgNtChem.Er
Europium	=SbSgNtChem.Eu
Fermium	=SbSgNtChem.Fm
Fluor	=SbSgNtChem.F
Francium	=SbSgNtChem.Fr
Gadolinium	=SbSgNtChem.Gd
Gallium	=SbSgNtChem.Ga
Germanium	=SbSgNtChem.Ge
Gold	=SbSgNtChem.Au
Hafnium	=SbSgNtChem.Hf
Hassium	=SbSgNtChem.Hs
Helium	=SbSgNtChem.He
Holmium	=SbSgNtChem.Ho
Indium	=SbSgNtChem.In
Iod	=SbSgNtChem.I
Iridium	=SbSgNtChem.Ir
Kalium	=SbSgNtChem.K
Kobalt	=SbSgNtChem.Co
Kohlenstoff	=SbSgNtChem.C
Krypton	=SbSgNtChem.Kr
Kupfer	=SbSgNtChem.Cu
Lanthan	=SbSgNtChem.La
Lawrencium	=SbSgNtChem.Lr
Lithium	=SbSgNtChem.Li
Lutetium	=SbSgNtChem.Lu
Magnesium	=SbSgNtChem.Mg
Mangan	=SbSgNtChem.Mn
Meitnerium	=SbSgNtChem.Mt
Mendelevium	=SbSgNtChem.Md
Natrium	=SbSgNtChem.Na
Neodym	=SbSgNtChem.Nd
Neon	=SbSgNtChem.Ne
Neptunium	=SbSgNtChem.Np
Nickel	=SbSgNtChem.Ni
Niob	=SbSgNtChem.Nb
Nobelium	=SbSgNtChem.No
Osmium	=SbSgNtChem.Os
Palladium	=SbSgNtChem.Pd
Phosphor	=SbSgNtChem.P
Platin	=SbSgNtChem.Pt
Plutonium	=SbSgNtChem.Pu
Polonium	=SbSgNtChem.Po
Praseodym	=SbSgNtChem.Pr
Promethium	=SbSgNtChem.Pm
Protactinium	=SbSgNtChem.Pa
Quecksilber	=SbSgNtChem.Hg
Radium	=SbSgNtChem.Ra
Radon	=SbSgNtChem.Rn
Rhenium	=SbSgNtChem.Re
Rhodium	=SbSgNtChem.Rh
Roentgenium	=SbSgNtChem.Rg
Rubidium	=SbSgNtChem.Rb
Ruthenium	=SbSgNtChem.Ru
Rutherfordium	=SbSgNtChem.Rf
Samarium	=SbSgNtChem.Sm
Sauerstoff	=SbSgNtChem.O
Scandium	=SbSgNtChem.Sc
Schwefel	=SbSgNtChem.S
Seaborgium	=SbSgNtChem.Sg
Selen	=SbSgNtChem.Se
Silber	=SbSgNtChem.Ag
Silizium	=SbSgNtChem.Si
Stickstoff	=SbSgNtChem.N
Strontium	=SbSgNtChem.Sr
Tantal	=SbSgNtChem.Ta
Technetium	=SbSgNtChem.Tc
Tellur	=SbSgNtChem.Te
Terbium	=SbSgNtChem.Tb
Thallium	=SbSgNtChem.Tl
Thorium	=SbSgNtChem.Th
Thulium	=SbSgNtChem.Tm
Uran	=SbSgNtChem.U
Vanadium	=SbSgNtChem.V
Wasserstoff	=SbSgNtChem.H
Wolfram	=SbSgNtChem.W
Xenon	=SbSgNtChem.Xe
Ytterbium	=SbSgNtChem.Yb
Yttrium	=SbSgNtChem.Y
Zink	=SbSgNtChem.Zn
Zinn	=SbSgNtChem.Sn
Zirkonium	=SbSgNtChem.Zr
